白岩松口才好，书法写得也不错	白岩松/nr
汶川地震十周年：逝者安息，生者坚强，白岩松的六句话令人深思！	白岩松/nr,汶川/ns
蔡军:当前中国高血压防治中存在的问题及可能的解决办法	蔡军/nr,中国/ns
不求名高 但为术精——记南通六院妇产科专家蔡烟岫	蔡烟岫/nr,南通/ns
如何评价曹宝麟（书法家）？	曹宝麟/nr
汶川大地震10年回顾：曾志伟江油检查援建项目 招牌笑容老少通杀	曾志伟/nr,江油/ns
适逢汶川地震十周年 谭咏麟率曾志伟等四川打慈善赛筹善款	曾志伟/nr,谭咏麟/nr,四川/ns,汶川/ns
适逢汶川地震十周年，谭咏麟率曾志伟等四川打慈善赛筹善款	曾志伟/nr,谭咏麟/nr,四川/ns,汶川/ns
陈敬伟：用好养殖“生物链”每亩水蛭省三千	陈敬伟/nr
陈忠专访：重视循证医学研究 规范腔内诊疗技术	陈忠/nr
上联：龙生九子，子子成龙，下联怎么对？	
怎样评价汶川地震后德阳什邡小男孩程强？	程强/nr,德阳/ns,什邡/ns,汶川/ns
程维：滴滴未来不再以竞争和烧钱为导向	程维/nr
程维：滴滴未来将不再以竞争和烧钱为导向	程维/nr
抑郁患者福音——崔永元约大师教你防治抑郁	崔永元/nr
汶川地震幸存者代国宏再回重庆 “无腿蛙王”感恩当年医护人员	代国宏/nr,汶川/ns,重庆/ns
亚冠中国德比出现球迷国骂，董路说那些人工资不过5千？	董路/nr,中国/ns
董鹏：第三届心血管临床病例讨论会侧记	董鹏/nr
董小姐：妈妈怎么烧菜，决定了糖尿病并发症？	董小姐/nr
董小姐专栏：八年，我得了糖尿病，而他——娶了我	董小姐/nr
「脱贫攻坚群英谱·养鸡大户」杜凯：互联网时代的带头养鸡人	杜凯/nr
应该如何评价硬笔书法名家范林庆的书法水准？	范林庆/nr
热点文章｜范志清：冠心病患者HIIT的获益与风险规避	范志清/nr
“萌犬旺旺”方楚雄书画作品首次亮相文博会	方楚雄/nr
「话风堂」明星家电董事长薪酬：方洪波年入1.7亿！	方洪波/nr
冯雪：适合心脏康复可持续发展的医疗模式探索	冯雪/nr
“赢在起跑线”是教育中最大的谎言，“坠落”奥数天才付云皓启示	付云皓/nr
农产品区域公用品牌运营过程中会遇到哪些问题——HCAA段高杰专访	高杰/nr
「未检」高唐：拒绝校园欺凌 护航未成年人	高唐/nr
观摩河西堡高鑫老师风湿骨病专科诊疗卫生室	高鑫/nr,河西堡/ns,专科诊疗卫生室/nt
歌蓝德：柑橘溃疡病的杀手锏，农药经营镇店之宝，专利产品！	歌蓝德/nr,镇店/ns
宫川英男牺牲后，八路军战士冒死将他的遗体带回来，安葬烈士陵园	宫川英男/nr
南京大屠杀元凶日军第六师团结局 军队基本全灭 谷寿夫被枪决	谷寿夫/nr,第六师团/nt
1.5亿豪宅曝光，关之琳分享房产投资秘诀	关之琳/nr
郭亚军：银行为什么不愿意向农户发放贷款？	郭亚军/nr
卢氏县东城学校四年级六班 郭懿<《重渡沟一日游记》>	郭懿/nr,卢氏县/ns,东城学校/nt
邓稼先找郭永怀研究氢弹单体结构的研究，看了图纸后大为称赞	郭永怀/nr,邓稼先/nr
期货论坛｜韩一军：开启农产品和棉花新时代	韩一军/nr
农业农村部部长韩长赋莅临我校调研指导	韩长赋/nr
「5·12汶川地震十周年」汉旺：毋需遗忘 亦能坚强	汉旺/nr,汶川/ns
如何评价抗日英雄郝梦龄？	郝梦龄/nr
何文林老师这几幅书法只看一眼就爱上了	何文林/nr
「洪昭光专栏」高血压必读：医生说的话比吃药还重要！	洪昭光/nr
胡歌的猎场大火，现实的猎场毛利率高达84%，猎聘网竟然要上市！	胡歌/nr
低分进普高真的就比艺术高中有前景吗｜武汉华艺圆高考升学梦	华艺圆/nr,武汉/ns,比艺术高中/nt
完成10年承诺 汶川地震举牌男孩成黄继光班班长	黄继光/nr,汶川/ns
广西近视手术专家-黄明汉院长9月9日百色见面会	黄明汉/nr
「书法」黄庭坚丨廉颇蔺相如列传	黄庭坚/nr
黄志龙：房地产繁荣会挤压消费吗？	黄志龙/nr
贾玉梅在我省部分景区暗访调研时强调 整合放大旅游资源优势加快推进旅游强省战略	贾玉梅/nr
简氏：中国正试飞歼15电子战机 设计类似美军EA18G	简氏/nr,中国/ns
都是学毛体，江青与林彪的书法差别在哪？	江青/nr,林彪/nr
如何评价姜文的书法，你觉得怎么样？	姜文/nr
你更喜欢谁的字？蒋氏父子书法欣赏	蒋氏/nr
如何评价首位女书法博士解小青的书法？	解小青/nr
静玮：与糖尿病抗争30年，互有胜负	静玮/nr
NBA篮球解说员一场球能赚多少钱？柯凡：杨毅一场球顶我三天工资	柯凡/nr,杨毅/nr
宫颈癌疫苗，柯建美药师精选问答	柯建美/nr
致敬老兵！“敬礼娃娃”郎铮终于找到当年的救命恩人！	郎铮/nr
10年前汶川地震中的“敬礼娃娃”郎铮 终于找到当年的救命恩人！	郎铮/nr,汶川/ns
汶川大地震十周年特别报道（十七）｜“敬礼娃娃”郎铮	郎铮/nr,汶川/ns
上联：老舍贴联庆春到，怎么对？	老舍/nr
累死老詹刚打赢猛龙，骑士后院着火！	老詹/nr
黎励文专访：传递诊疗技术新理念 推动心衰一体化管理	黎励文/nr
60岁李保芳执掌茅台 薪酬仅比五粮液董事长高	李保芳/nr
上党战役胜利，李德生带领769团缴获了哪些“洋财”？	李德生/nr
「书法」安徽省太和县李福俊老先生书法作品欣赏	李福俊/nr,安徽省/ns,太和县/ns
李克强：中国愿更多进口北海道安全放心有品质的农产品	李克强/nr,中国/ns
杨紫琼躲过尼泊尔地震，李连杰海啸护幼女——那些与死神擦肩而过	李连杰/nr,杨紫琼/nr
李敏镐入伍遭虐待回家修养？晒豪宅引起部队怀疑：逃兵还是养伤？	李敏镐/nr
纳溪区副区长李明带队到“花田酒地”景区检查节前安全工作	李明/nr,纳溪区/ns
李瑞杰：国家中医药发展战略环境下的心脏康复	李瑞杰/nr
李斯书法：对统一有贡献，对艺术无益处	李斯/nr
「说事」李显冬教授谈考研那点事	李显冬/nr
李雪健老师的书法该如何欣赏？	李雪健/nr
李宇春的字虽谈不上书法 却也如同其人一样美	李宇春/nr
李玉明：妊娠期高血压疾病的个体化防治策略	李玉明/nr
书法家李元忠 群鸿戏海鸾翔凤翥	李元忠/nr
用五吨炮弹换下李云龙！五吨炮弹到底有多少？	李云龙/nr
汶川地震第一个跳伞营救的勇士，他叫李振波，现在怎么样了	李振波/nr,汶川/ns
一手好字，相伴一生｜品鉴李治坤书法	李治坤/nr
诗词欣赏：赋得暮雨送李胄	李胄/nr
廖伟夫书法新作欣赏	廖伟夫/nr
上联：美好回忆林忆莲，下联怎么对？	林忆莲/nr
如何评价欧楷名家林则徐的书法水准？	林则徐/nr
观市：江苏凌家塘市场 4月水产品供需稳定 价格同比不高	凌家塘/nr,观市/ns
热点课件｜刘斌：高血压合并心力衰竭患者的血压管理	刘斌/nr
开启晒娃模式，刘国栋为女儿请教练，国乒小将来应聘	刘国栋/nr
很多患者不喜欢医生实话实说，更相信刘洪滨、张悟本	刘洪滨/nr,张悟本/nr
这招聘谁敢接！刘家国字辈二代欲请私教 网友：大688请小688啊！	刘家国/nr
汶川地震十周年，你们还好吗？刘晶歌唱《每个人的力量》祈福	刘晶/nr,汶川/ns
刘力红：你们真怕“上火”吗？乱喝凉茶小心大病来得快！	刘力红/nr
当年在灾区出生的“地震宝宝”取名“刘念军”，如今已经十岁了	刘念军/nr
刘强东：对于给员工加薪这事上，谁都不服，就服这套薪酬加薪方式	刘强东/nr
刘强东：我就想融100万，把哥几个的工资发了！	刘强东/nr
不忘初心走故里，游花明楼景区，访刘少奇故居	刘少奇/nr,花明楼/ns
刘少奇书法，写得有味道！	刘少奇/nr
著名钢琴大师刘诗昆走进临夏市4A级景区八坊十三巷	刘诗昆/nr,临夏市/ns
刘文源老书法师作品选	刘文源/nr
刘希彦：为何中青年人得大病越来越快、得小病越来越难？	刘希彦/nr
大地震10周年，刘翔当年立即捐款350万，3个月后却成全国罪人	刘翔/nr
汶川大地震10周年纪念特刊｜刘晓莉：北川行	刘晓莉/nr,汶川/ns
刘志强：炒房危害大 租房市场同样不容炒	刘志强/nr
卢奕教授8月19日来厦坐诊，专治各种疑难白内障	卢奕/nr
鲁迅曾自称一段时间内“工资350大洋”，换成现在的人民币大概是多少？	鲁迅/nr,大洋/ns
鲁迅每月工资350块大洋，换成现在的人民币值多少钱？	鲁迅/nr
鲁迅书法VS胡适书法，你喜欢谁的？	鲁迅/nr,胡适/nr
路飞淡定回到海军本部，海军吓得动弹不得，草帽两年后的集结！	路飞/nr
我的生命属于病人——记我国著名肝病专家骆抗先	骆抗先/nr
如何看待央视财经专家马光远的炒房无罪论？	马光远/nr
滴滴顺风车下线整改一周；马化腾再成中国首富	马化腾/nr,中国/ns
汶川地震十周年，马龙、马琳、许昕、张继科等国乒队员发博致敬	马琳/nr,张继科/nr,许昕/nr,汶川/ns,国乒队/nt
电磁弹射！令西方炸锅，马伟明：中国003型航母技术领先美国	马伟明/nr,西方/ns
5月8日畜牧早新闻：马有祥：今年养猪保本微利，明年猪价不容乐观	马有祥/nr
农业农村部司长马有祥：今年养猪保本微利，2019年猪价不容乐观！	马有祥/nr
马云突然杀入！这次滴滴真遇到对手，网友：马云干的漂亮！	马云/nr
马云对于房地产未来的判断，你也认同吗？	马云/nr
房地产已变天，马云预言未来房子不值钱可能是这样的结果	马云/nr
滴滴还扛得住吗？马云也出手了	马云/nr
滴滴真正的对手来了！马云突然杀入！	马云/nr
滴滴真正的对手来了！马云也正式出手了！	马云/nr
滴滴打车这么危险，马云坐不住了，他有奇招	马云/nr
刚刚，马云突然宣布，滴滴、携程或要哭了！	马云/nr
网约车混战再起，马云强势杀入，网友：还是滴滴好	马云/nr
马云：未来3年最吃香的专业，从不怕失业，薪资水平一点都不低！	马云/nr
橘子洲景区毛泽东雕像做深层清洁“美容”	毛泽东/nr,橘子洲/ns
长沙：橘子洲景区给毛泽东沙雕深层清洁“美容”	毛泽东/nr,橘子洲/ns,长沙/ns
毛泽东手书信封书法，无意书家，已至大家	毛泽东/nr
毛主席青年时期的书法真迹	毛主席/nr
毛主席：书法与写字有区别	毛主席/nr
毛主席经典诗词摘录「2」	毛主席/nr
毛主席的这些字，能看懂的都是书法大师！	毛主席/nr
如何评价茅于轼“廉租房不应该配独立厕所”背后的经济学逻辑？	茅于轼/nr
为什么反复告知，而患者宁信传闻而不信医生？	宁信/nr
苏轼书法《欧阳修醉翁亭记》你看过吗	欧阳修/nr
欧阳询 楷书《千字文》欣赏	欧阳询/nr
练楷书只能从颜真卿，柳公权或者欧阳询开始吗？	欧阳询/nr,颜真卿/nr
潘石屹海南发家之路：搬砖和炒房	潘石屹/nr,海南/ns
罗大伦“杠”上裴洪岗：国人不能喝冰水是中了中医的毒？	裴洪岗/nr,罗大伦/nr
彭水正洞坪村以“合作社+农户”模式发展黄豆产业	彭水正/nr,洞坪村/ns
先冻结房产，再冻结养老活命钱，韩国为何如此苛刻对待前总统朴槿惠？	朴槿惠/nr
启功书法：分为两类，各有精彩	启功/nr
如何评价上海唯一的书法名师钱沛云的硬笔书法？	钱沛云/nr,上海/ns
钱学森当年不顾一切回国，如今对比其在两国的薪酬，令人肃然起敬	钱学森/nr,两国/ns
士兵怒斥军长下命令啰嗦，秦基伟非但没生气反而用来教育儿子秦天	秦基伟/nr,秦天/nr
秦始皇曾祖留下一项伟大工程，历经两千多年，8级地震都无法摧毁	秦始皇/nr
10年了，牺牲在汶川救灾前线的特级飞行员邱光华五烈士，安息何处	邱光华/nr,汶川/ns
邱光华，汶川地震抗震救灾中牺牲的失事机长，副师职，追记一等功	邱光华/nr,汶川/ns
英雄邱光华救灾多次飞过家乡上空，看到家里房屋倒塌没有落地回家	邱光华/nr
如何评价当代书坛瘦金体翘楚邱金生的书法？	邱金生/nr
“仁心妙手护士”邱逸红：“一针见血的神枪手”	邱逸红/nr
瞿良：汶川地震那年我18岁，一天就长大了	瞿良/nr,汶川/ns
著名中医文化专家曲黎敏：彻底把头疼说清楚	曲黎敏/nr
儿科任献青博士：川贝蒸梨这样让孩子吃，止咳效果最好了	任献青/nr
儿科任献青博士：为啥你家孩子会过敏？	任献青/nr
恒大又现“高薪挖角” 薪酬或比任泽平1500万还高	任泽平/nr
恒大又出重金挖人：薪酬或比任泽平1500万还要高	任泽平/nr
又见恒大出重金挖人！薪酬或比任泽平1500万还要高	任泽平/nr
又见恒大出重金挖人！这次挖的是来自四大行的投行重磅人物，薪酬或比任泽平1500万还要高	任泽平/nr,四大行/nt
恒大重金挖角农行投行部总裁于建忠 薪酬或比任泽平1500万还要高	任泽平/nr,于建忠/nr,农行投行部/nt
任志强预测2018年房地产要降，你觉得呢？	任志强/nr
任志强说现在是“抄底时机”，购房者该不该信？	任志强/nr
任志强预测2018年房地产要降，是真的要降价吗？	任志强/nr
潘石屹认为房产畸形任志强唱反调！买房者该信谁的话	任志强/nr,潘石屹/nr
如今房产值得投资吗？看任志强与潘石屹两位房产大佬怎么说	任志强/nr,潘石屹/nr
三毛定居的宿命小岛，地震频发或将不复存在？	三毛/nr
地震中救出15人的搜救犬沈虎：英雄暮年，终于可以撒娇卖萌呜呜叫了	沈虎/nr
遇见·沈琳｜对于患者生命，肿瘤医生比谁都“贪婪”	沈琳/nr
施柯：新东方紧跟高考改革趋势 满足学生各层需求	施柯/nr
我院苏藩教授获评中医眼科学科建设与学术发展突出贡献奖	苏藩/nr
孙宁玲+陈晓平：第七届中国高血压大会	孙宁玲/nr,陈晓平/nr
孙文启——新时代最具收藏价值画家	孙文启/nr
汤神自我牺牲！愿为库里KD腾出6000万薪金空间 助勇士留住死亡五小	汤神/nr
上联：风流才子唐伯虎，如何对下联？	唐伯虎/nr
初学书法选择田英章字帖合适吗？	田英章/nr
品鉴田英章楷书，我们得到以下信息	田英章/nr
田蕴章的书法水平是什么级别的？	田蕴章/nr
田蕴章教授《每日一字真行草三体书法》之三	田蕴章/nr
从全校最后一名逆袭到第1名高考上复旦，童弟周说一定要争气	童弟周/nr
汪国真诗词欣赏系列 失落	汪国真/nr
汪国真诗词欣赏系列 美与风度	汪国真/nr
能否评价一下汪精卫的书法水准？	汪精卫/nr
王宝强鼓励老家养猪户让邻居村民入股分红，没想到人家媳妇不干了	王宝强/nr
中医名家辨治实录：王道坤胃癌辨治经验	王道坤/nr
日本人为什么会推崇降臣王铎的书法？	王铎/nr
王红宇：Brugada综合征患者Tp-Te间期增大	王红宇/nr
王健林：最有钱的不是房地产，是银行！另一位听后笑而不语	王健林/nr
王立伟：提升教育整体水平 解决入学难入园贵等问题	王立伟/nr
王珞丹租房至今，还有哪些明星租房住？	王珞丹/nr
云田诗词：题王蒙《春山读书图》	王蒙/nr,云田/ns
六安市舒城县张母桥镇贫困户王升荣的养猪脱贫记	王升荣/nr,张母桥镇/ns,舒城县/ns
王胜煌：原发性 or 继发性高血压？	王胜煌/nr
王胜煌：冠脉微血管病变与慢血流的中医药治疗实践进展	王胜煌/nr
这么美的书法怎能不爱！褚遂良摹王羲之兰亭序	王羲之/nr,褚遂良/nr
王新艾诗词赏析：仰望楼兰	王新艾/nr,楼兰/ns
王勇强调全面提升国家综合防灾减灾能力	王勇/nr
王勇在国家减灾委员会全体会议上强调 不断提升防灾减灾救灾能力	王勇/nr
王勇总队长督查太原冬春火灾防控工作	王勇/nr,太原/ns
被老师放弃最不强大脑王昱珩全校第一上清华美院的高考故事	王昱珩/nr
第一个着陆汶川的战士魏建红：难忘袍泽情	魏建红/nr,汶川/ns
新活法·党员精彩故事 | 火情“排头兵”党员消防指挥员温鑫	温鑫/nr
「书法」文征明小楷《草堂十志》	文征明/nr
文征明的书法才是雅俗共赏	文征明/nr
《战狼2》中吴京用铁丝板档火箭弹，这在现实中可能吗？	吴京/nr
海峡动新闻：吴晓波谈房地产发展	吴晓波/nr
浙江诸暨-西施故里，4A级风景区 五泄	西施/nr,诸暨/ns,浙江/ns
亲历汶川地震：90后女孩返乡带村民卖水果脱贫 被赞“樱桃西施”	西施/nr,汶川/ns
这家位于“汶川特大地震的震源地”的饭馆，习近平也曾做客品尝	习近平/nr,汶川/ns
任泽平、夏磊等：房地产周期（下）	夏磊/nr,任泽平/nr
「谢静」“糖尿病人选择主食”参考指标	谢静/nr
徐静蕾书法：有线条化倾向，墨韵稍有不足	徐静蕾/nr
“白卷考生”徐梦南十年后再考大专：望广大学子好好珍惜高考机会	徐梦南/nr
徐霞客号被海军“点名”，或许001A航母真的要海试了？	徐霞客/nr
徐晓东的挑战武林及对中医的意义	徐晓东/nr
徐峥小陶虹夫妇《信中国》，致敬汶川地震救灾英雄，缅怀遇难同胞	徐峥/nr,小陶虹/nr,中国/ns,汶川/ns
许家印从严治军！扣工资！严惩张琳芃胶带球衣事件！	许家印/nr,张琳芃/nr
许家印下令！严惩张琳芃DIY球衣事件 总经理领队队务被降三级工资	许家印/nr,张琳芃/nr
许静：老年房颤患者口服抗凝剂的应用	许静/nr
无锡蠡园、薛家花园、薛福成故居一日游	薛福成/nr,无锡/ns
汶川地震十年，鄢磊回忆在震区的254个小时（二）	鄢磊/nr,汶川/ns
儿科闫永彬教授：脾胃虚寒和脾胃湿热的孩子怎么食疗？	闫永彬/nr
“严书记女儿”遭热议后续：嘉祥外国语学校否认内定录取该生	严书记/nr,外国语学校/nt,嘉祥外国语学校/nt
阎锡山发明的这个手榴弹，遭到了所有人的嘲笑，但没想到效果很好	阎锡山/nr
上联：颜如玉，如何对下联？	颜如玉/nr
颜真卿书法《真书千字文》，真迹？	颜真卿/nr
颜真卿书法大观（作品赏析与特征分析）	颜真卿/nr
江苏名中医杨桂云 最爱的是这两种……	杨桂云/nr,江苏/ns
无畏的特种兵杨建松 大理人的骄傲！	杨建松/nr
上联：杨柳绿千里，如何对下联吗？	杨柳绿/nr
辽宁男篮队长杨鸣被聘为“辽宁省防灾减灾公益形象大使”！	杨鸣/nr,辽宁省/ns
杨鸣被聘为“辽宁省防灾减灾公益形象大使” 西装革履帅气满分	杨鸣/nr,辽宁省/ns
转载 歼20总设计师杨伟 一篇高屋建瓯的演讲	杨伟/nr
广安门医院姚魁武：面对高血脂病症，素食也帮不了您~	姚魁武/nr,广安门/ns
叶檀要来！关乎2018合肥楼市！购房者最关心的4大问题！	叶檀/nr,合肥/ns
「2018年第17场战报」林泽键梅开二度，叶勇浩暴雨中绝杀吴川巨龙	叶勇浩/nr,吴川/nr
原农行投资银行总裁于建忠将加盟恒大 薪酬或超1500万	于建忠/nr
“妙手护士”余桂芳：国内率先开展糖尿病专科护理门诊	余桂芳/nr,糖尿病专科护理门诊/nt
「千阳大学生村官风采」余静：给群众一份力所能及的温暖	余静/nr,千阳/ns
这支部队现有17万现役官兵，还有20余万非现役人员即将面临改革	余万非/nr
美力盾蛋鸭增蛋素——专访张彬产蛋量高峰期在98%的养殖心得！	张彬/nr
如何评价田径界"泥石流"张国伟？	张国伟/nr
著名书法家张海为自己立“卧薪尝胆状”	张海/nr
癌症患者的心理支持及照护技巧｜张海蓁 暖直播	张海蓁/nr
如何评价硬笔书协主席张华庆的书法水准？	张华庆/nr
如何评价硬笔书法协会主席张华庆的书法水准？	张华庆/nr
军纪严明！恒大就张琳芃球衣事件公布处罚：经理领队各降三级工资	张琳芃/nr
张琳芃球衣门处罚结果出炉，恒大给五人降工资，影响品牌形象	张琳芃/nr
张琳芃球衣事件，导致恒大5人遭重罚！不罚款，直接降三级工资	张琳芃/nr
9日体育热点：亚冠张琳芃血染赛场无球衣可换 恒大重罚管理人员：降3级工资	张琳芃/nr
亚冠张琳芃血染球衣无备用球衣可换 恒大作出处罚：降三级工资	张琳芃/nr
亚冠张琳芃血染赛场无球衣可换 恒大重罚管理人员：降3级工资	张琳芃/nr
总经理领队队务降三级工资 恒大就亚冠张琳芃球衣事件作出处罚	张琳芃/nr
张敏州:中医防治急性心肌梗死的优势探讨	张敏州/nr
张明玺：养老信托国际经验与国内实践之六——发展建议	张明玺/nr
恒大不职业许家印怒了！张琳芃竟穿张文钊球衣 总经理被降3级工资	张文钊/nr,许家印/nr,张琳芃/nr
张永庆专访：基础与临床并举 提高基层医护人员诊疗水平	张永庆/nr
张召忠的职业是什么，为什么对军事了如指掌？	张召忠/nr
美军在美国大片里的表现现实中真有那么强吗？看局座张召忠怎么说	张召忠/nr
张作霖的东北军工多强大？	张作霖/nr,东北/ns
教招上新！2018南通市通州区教育系统招聘教师128名，21日起报名	招上新/nr,南通市/ns
上联：泰山黄山赵本山，如何对下联？	赵本山/nr,黄山/ns,泰山/ns
为什么亮剑里边赵刚大学刚毕业到部队就是团政委？	赵刚/nr
赵构书法，得晋人韵？	赵构/nr
赵国安：2016ESC急慢性心衰诊治指南更新要点	赵国安/nr
赵继伟转发汶川地震10周年视频：加油中国！	赵继伟/nr,中国/ns,汶川/ns
赵剑平｜中国当代实力派书法家	赵剑平/nr,中国/ns
临赵孟頫的书法	赵孟頫/nr
「书法」绝美！赵孟頫《续千字文》	赵孟頫/nr
历代名家书法精品——赵孟頫《信札》二十六幅	赵孟頫/nr
郑小胡景区旅游企业调研：进一步擦亮旅游品牌 提升旅游吸引力和	郑小胡/nr
中华书法高清法帖——《智永千字文》04	智永/nr
上犹县2017年公开招聘钟桂梅教师体检补检情况公示	钟桂梅/nr,上犹县/ns
诗词丨蔡建和：浩淼湘江来万里，钟灵楚地风流	钟灵楚/nr,蔡建和/nr,湘江/ns
上联：孟达不及仲达，下联怎么对？	仲达/nr,孟达/nr
看看周慧珺的楷书！	周慧珺/nr
火箭为什么始终不肯裁掉周琦？看完周琦的工资你就知道了	周琦/nr
火箭一人堪比周琦，整个系列赛仅得2分，薪资是周琦80倍	周琦/nr
为何火箭始终不裁掉周琦？看完他的工资你就知道了！	周琦/nr
为什么火箭不裁掉周琦？看完工资，球迷都得夸：老板真机智！	周琦/nr
摆烂球队十倍工资挖饼皇？这对周琦来说可能是个好消息	周琦来/nr
俸周耀：房地产品牌21条商规	周耀/nr
扩散周知！5月10日起，华山景区门票降价啦！	周知/nr,华山/ns
汶川地震“被刨出的女人”周仲菊见到救命之人	周仲菊/nr,汶川/ns
汶川地震中牺牲军衔最高的军官：由周总理任命 再过一年就退休了	周总理/nr,汶川/ns
邱光华，周总理挑选的第一批少数民族飞行员，汶川地震中失事机长	周总理/nr,邱光华/nr,汶川/ns
本赛季朱婷已经拿到了四个冠军，下个赛季朱婷的薪资大概会是多少？	朱婷/nr,朱婷/nr
2017年董秘薪酬榜出炉：万科董秘朱旭822万夺冠最穷董秘年薪仅1万	朱旭/nr
「石汉平」肿瘤患者的营养问题	石汉平/nr
「科普营养」石汉平：肿瘤病人的幸运数字—“5”	石汉平/nr
田九亭书法篆刻小议	田九亭/nr
「小楼荐诗」魏新河诗词精选（22首）	魏新河/nr
土耳其军占领阿夫林后， 扬言进攻美军阵地， 美土会开战吗？	阿夫林/ns
白马涧龙池景区	白马涧龙池/ns
秦皇岛市冰塘峪一日游，可惜没有登山玻璃栈道	冰塘峪/ns,秦皇岛市/ns
厦门环岛路，胡里山炮台，曾厝垵一日游攻略	胡里山/ns
我的旅行日记｜兵马俑华清宫一日游攻略~	华清宫/ns
快来瞧瞧！城口黄安坝高山草场风景区有新变化	黄安坝/ns
八达岭长城、黄鹤楼等标志性景区点亮“欧盟蓝”	黄鹤楼/ns
「直通校园」晋源区晋源街道北瓦窑小学学宪法讲宪法主题活动	晋源/ns,晋源区/ns
汉中黎坪景区剑峡自然风光	黎坪/ns,剑峡/ns,汉中/ns
山西夏县鲁因村村主任被指“操控枣运物流致枣农利益受损”	鲁因/ns,夏县/ns,山西/ns
惠州市罗浮山旅游风景区景点	罗浮山/ns,惠州市/ns
罗溪国家森林公园高登山景区——日出云海映山红，杜鹃花下惹人醉	罗溪/ns
号称闽南“西双版纳”的泉州牛姆林风景区好玩吗？	牛姆林/ns,闽南/ns,泉州/ns
新北必访经典游程瑞芳一日游寻幽访古5景点	程瑞芳/ns,新北/ns
沙坡头景区最新消息	沙坡头/ns
景区火不火不重要，重要的是嗨不嗨！沙坡头假期第二天	沙坡头/ns
汶川大地震，现成震惊中外的“唐家山堰塞湖”，是如何被排除的？	唐家山/ns,汶川/ns
刚需购房者还需尽快出手，济南唐冶房价即将进入2万+时代	唐冶/ns,济南/ns
江西“汪山土库”一日游——赣派建筑与宫庭建筑结合之美	汪山土库/ns,江西/ns
准备好捡“相因”！武侯祠等22个景区将陆续实行免费开放日，攻略请戳→	武侯祠/ns
南阳武侯祠等景区亮相南阳旅游成都推介会	武侯祠/ns,南阳/ns,成都/ns
武鸣灵水景区遭投诉：游客直呼“被坑” 官方回应	武鸣灵水/ns
武鸣灵水风景区遭投诉，有人直呼“被坑”！官方回应称……	武鸣灵水/ns
「重磅」武胜考生注意了！四川2018年高考实施规定出台	武胜/ns,四川/ns
浦城第一期乡村旅游从业人员培训班在小密景区开班！	小密/ns,浦城/ns
2018宿城一中宿马校区招聘、选调教师33人公告	宿马/ns
为什么伊郎不能有核武器，而美国有核武器？	伊郎/ns
易疆游｜新疆哪些地方适合自驾游，路途景色漂亮	易疆/ns,新疆/ns
重庆龚滩古镇景区游	龚滩古镇/ns,重庆/ns
航拍汶川地震后新老城对比 映秀最美、北川宜居、汉旺冷清	汉旺/ns,汶川/ns
李沧一男子酒后驾驶试乘试驾车辆被查	李沧/ns
西海岸鲁信随珠花园施工现场失火！	鲁信随珠/ns
中国旅游局、北川县齐帮扶 猿王洞十年“蝶变”成九皇山景区	猿王洞/ns,中国/ns,北川县/ns
暗访哈尔滨网约车：下10单来7辆“黑车” 1辆套牌	哈尔滨/ns
“5·19中国旅游日”云南将推出115条惠民措施 景区或免费降价	中国/ns,云南/ns
成都首发减灾文化旅游导览图，12区共20个点位入选	成都/ns
房天下每日成交5月12日海宁商品房销售备案43套	海宁/ns
5月12日汶川大地震十周年纪念，十年前的这一天你在干什么，感受到了什么？	汶川/ns
为2008年5月12日汶川大地震中逝去的人们默哀	汶川/ns
5月19日晋城多家旅游景区免门票	晋城/ns
2008年汶川地震，被废墟埋了36天的（猪坚强）现在怎么样了	汶川/ns
外国摄影大师镜头下的2008年汶川地震灾区 真实而冷峻	汶川/ns
「2018年鞍山中考招生政策公布」报名人数减少录取率增加	鞍山/ns
为什么报考2018年保定农信社招聘考试？好处有哪些？	保定/ns,农信社/nt
2018年常州中考自主招生开考 全市约4000考生报名	常州/ns
2018年滁州明光市基层医疗机构招聘笔试成绩公示	滁州/ns,明光市/ns
2018年贵州高考报名突破44万人，考生比去年增加29834人！	贵州/ns
2018年贵州事业单位招聘联考类别科目，你了解多少？	贵州/ns
2018年江西高考成绩查询时间	江西/ns
2018年江西理科一模590分可以上什么大学？	江西/ns
重磅！2018年胶州中小学招生、报名开始啦	胶州/ns
2018年金川集团镍盐有限公司扩能项目招聘40人公告	金川/ns,盐有限公司/nt
2018年金陵小学（仙林湖校区）一年级新生招生通告	金陵/ns
最新！2018年鹿泉义务教育招生工作通知发布！一起来看看都讲了啥？	鹿泉/ns
2018年南昌小升初民办公办生源抢夺赛激烈，公办学校有崛起之势	南昌/ns,公办学校/nt
石嘴山招30人！2018年宁夏特岗招聘公告出来了，14号开始报名！	石嘴山/ns,宁夏/ns
2018年潍坊高新区义务教育学校新生入学 信息采集公告	潍坊/ns,高新区/ns
2018年烟台夏季高考考点公布，全市有31763人报名考试	烟台/ns
2018年云南文山州特岗教师招聘公告2239人	文山州/ns,云南/ns
2018年运城13县45所高中特长生招生计划出来了！	运城/ns,高中/nt
定了！2018年运城13县45所高中特长生招生计划出来了！	运城/ns,高中/nt
2018年漳州市直公办小学一年级招生工作的意见出炉	漳州/ns,市直公办小学/nt
2018年漳州芗城市区公办学校初中一年级招生工作的意见出炉	芗城/ns,漳州/ns,市区公办学校初中/nt
我报了个3000一人的云南五日游，会被强制消费吗？	云南/ns
房天下每日成交5月6日海宁商品房销售备案26套	海宁/ns
5月6日孝感房产网签22套 成交均价6544元/㎡	孝感/ns
5月7日金华商品房成交57套 二手房成交102套	金华/ns
5月7日南宁商品房签约344套 存量房交易141套	南宁/ns
5月7日苏州商品房成交198套，二手房成交374套	苏州/ns
5月7日无锡商品房备案成交296套 环涨188套	无锡/ns
5月8日南宁商品房签约317套 存量房交易126套	南宁/ns
5月8日苏州商品房成交263套 住宅成交207套	苏州/ns
5月8日苏州商品房成交263套，二手房成交417套	苏州/ns
房天下每日成交5月9日海宁商品房销售备案36套	海宁/ns
4月超八成城市房租环比下跌 昆明环比下降0.17%	昆明/ns
武汉东湖生态旅游风景区，武汉十大浪漫景点，十里磨山，八里飘香	东湖/ns,武汉/ns
百道书单｜十年生死两茫茫，这些书真实再现了“5·12”汶川特大地震	汶川/ns
第一个对全国公安民警免费开放的国家5A级景区、中华十大名山长白山五一小长假迎来首批民警游客	长白山/ns
“暖春·援梦”关爱高考生龙江高校大型公益巡讲第二季第二站走进佳木斯	龙江/ns,佳木斯/ns
山东滨州有一个中国上市公司第一村，一言不合就发钱，养老全免费，你怎么看？	滨州/ns,山东/ns,中国上市公司/nt
河南一景区，被誉“中原第一峡”，美爆了，门票仅40元！	河南/ns,中原/ns
东非多国遭遇罕见洪水，索马里河流变化惊人！数十万人流离失所	东非/ns
“5·19中国旅游节”来啦！黄山景区发布惠民政策	中国/ns,黄山/ns
济宁市推出多项旅游惠民措施 部分景区让游客敞开耍	济宁市/ns
云南将推115项旅游惠民措施 部分景区免费或降价	云南/ns
云南将推出115项旅游惠民措施 部分景区免费或降价	云南/ns
奈曼旗白音昌卫生院，先诊辽后付费，心系患者，为民惠民	奈曼旗/ns,白音昌卫生院/nt
喜讯！河南天香农业有限公司启动惠农服务大会！	河南/ns,服务大会/nt,天香农业有限公司/nt
自驾游到阿尔山几月份最好？	阿尔山/ns
安仁师范班｜书法：一面镜子，一条道路	安仁/ns
贵州5个5A景区，安顺坐拥两个，旅游收入却令人意外？	贵州/ns,安顺/ns
澳珀斯机场航站楼因火警紧急疏散乘客	澳珀斯/ns
虚惊一场？澳珀斯机场航站楼因火警紧急疏散乘客	澳珀斯/ns
重庆138人通过清华北大自主招生初审 巴蜀中学36人再进全国前十	重庆/ns,巴蜀/ns
512大地震10周年！汶川震区大变样，还给人间一个锦绣巴蜀	汶川/ns,巴蜀/ns
白银区第八小学开展争做文明使者禁毒活动	白银区/ns,第八小学/nt
农作物被暴风雨横腰折断 广西大化百马乡5370亩玉米地受灾	广西/ns,百马乡/ns
勉县政协主席到褒城镇视察指导稻田泥鳅养殖项目	勉县/ns,褒城镇/ns
宝鸡考生请注意 2018年中高考政策有变化啦！	宝鸡/ns
陕西宝鸡出台义务教育招生方案：民办学校不得提前录取新生	陕西/ns,宝鸡/ns
想在宝鸡置办一套房产，刚需，现在价格怎么样？	宝鸡/ns
宝鸡王家山村男子发展生态农业并尝试农家乐打搅团，人气旺	宝鸡/ns
上联：宝鸡啄食陈仓米，怎么对下联？	宝鸡/ns
宝鸡适合养老吗？	宝鸡/ns
南宝山下的生态鱼养殖基地	宝山/ns
宝塔山景区保护提升工程 今年10月份建成投用	宝塔山/ns
延安宝塔山景区保护提升工程 今年10月份建成投用	延安/ns,宝塔山/ns
保定：冉庄明清园一日游	保定/ns
保定八大景区，推荐这三个必须看	保定/ns
这个季节去河北保定唐县秀水峪景区去怎么样，景区景色如何？	河北/ns,唐县/ns,保定/ns
滴滴又遇麻烦，保定要求立即停止违规经营行为！	保定/ns
保定周边有什么适合养老的楼盘推荐？	保定/ns
在保定一月7000-9000的工资算什么水平？跟外面单干的比哪个会好些？	保定/ns
保定市考摩托车驾照需要多少钱？多久？	保定市/ns
招聘啦！北辰区2018年事业单位公开招聘工作人员	北辰区/ns,事业单位/nt
美军第二舰队2.0版剑指北极熊！俄罗斯只有一招应对	北极/ns,第二舰队/nt
如果从长春出发去最北漠河，呼伦贝尔大草原，满州里自驾游一圈，能否推荐一下线路？	长春/ns,北漠河/ns,呼伦贝尔/ns
南三亚北威海，你会选择在哪里养老呢	三亚/ns,海南/ns,北威海/ns
辽宁本溪水洞风景区	辽宁/ns,本溪/ns
「最多省270元！」辽宁4家5A景区推联票 本溪这个地方要火……	辽宁/ns,本溪/ns
直击：比凤凰古镇还坑的景区，游玩一圈收8次费，如今无人问津	凤凰古镇/ns
走进云南丙中洛镇景区随拍	云南/ns,丙中洛镇/ns
博兴交警依托执法站严查“两客一危一货”违法行为	博兴/ns,执法站/nt
巴布亚新几内亚附近海域发生6级地震	新不列颠岛/ns
新不列颠岛地区发生6.0级地震 震源深度30千米	新不列颠岛/ns
2018云南五华区科技产业园开发投资招聘笔试结果及面试通知	云南/ns,五华区/ns
西藏昌都市年平均工资有多高？	西藏/ns,昌都市/ns
“6年免检”的含义你真的知道嘛？昌邑交警蜀黍权威解答	昌邑/ns
「教育」牛！常德7名学霸通过清华北大自主招生初审	常德/ns
这才是国军真正的硬骨头部队：血战常德、孤守衡阳，到最后一人	衡阳/ns,常德/ns
常德交警四大队：联合夜查行动成效显著	常德/ns,交警四大队/nt
常宁：30亩包菜滞销 菜农徐棉成全城寻买主	常宁/ns,徐棉/nr
5.19 中国旅游日，朝阳山景区免门票了！	中国/ns,朝阳山/ns
俄军基地屡遭威胁，普京大怒调来车臣部队，这下稳了	车臣/ns
200多亩葡萄架，被“谁”搞倒一半多；新邵陈家坊镇果农伤不起	新邵/ns,陈家坊镇/ns
来承德兴隆山景区玩 选景点，农家院小攻略	承德/ns
邵阳市养殖业环保督查城步	邵阳市/ns,城步/ns
从果农到经纪人 把城固柑桔卖到国外	城固/ns
恩施州各县市城区范围基准地价和征地补偿价格现状！	恩施州/ns
诗词欣赏：赤壁	赤壁/ns
下联：赤壁怀古，战马声嘶今犹在。上联怎么对？	赤壁/ns
想自驾游西藏，成都出发，川藏南线进，川藏北线出14天时间够吗？	西藏/ns,成都/ns
如何看待贵州中天，在成都春熙路拿地搞房地产？	贵州/ns,成都/ns,春熙路/ns
七月份从包头到山东，十五天左右，有自驾游路线推荐吗？	山东/ns
哈尔滨人也能吃上从化荔枝！“互联网+”助广州果农富起来	广州/ns,从化/ns
周末休闲农家游~肃州湿地景观大道满足你！串联五大湿地景区，途经数个乡镇，就是这么赞！	肃州/ns
「对对联」昆明大观楼长联字多情真联长	昆明/ns,大观楼/ns
紧急！神农架大九湖景区因强降雨暂停售卖换乘车票	大九湖/ns,神农架/ns,大九湖/ns,神农架/ns
云南大理到西藏自驾游需要多长时间？	西藏/ns,云南/ns,大理/ns
老司机们注意啦！大理交警向景点景区交通乱象“亮剑”！	大理/ns
想七月从成都出发去泸沽湖，大理，丽江，四个人自驾游，需要准备什么，当地的风俗忌讳？	丽江/ns,泸沽湖/ns,成都/ns,大理/ns
自主招生｜大连共53人通过清北自招初审！看看辽宁哪些高中更强	辽宁/ns,大连/ns
大连都有哪些知名高校？	大连/ns
大连一日游靠谱吗？	大连/ns
大连上调租房公积金提取额	大连/ns
大连做二手房改造时，这些问题要注意	大连/ns
大连3.22限购令后了房地产市场你怎么看？	大连/ns
大连船厂又有新动作？此配件成功下线，核动力航母或将开建	大连/ns
关于“打车”这件事！大连专门开了一场“新闻发布会”	大连/ns
在大连西山水库买房养老好不好？	西山/ns,大连/ns
一千万吨核弹暗藏太平洋 可激起五百米海啸 摧毁半个美洲大陆	太平洋/ns
大码头镇西刘桥小学开展交通安全知识竞赛	大码头镇/ns,西刘桥小学/nt
上联：太原太大大太原，如何对下联？	太原/ns,大太原/ns
大郑州的二手房价位真的向下浮动了！是购房最佳时机吗？	大郑州/ns
温氏集团大庄乡养猪小区投产	大庄乡/ns
丹景台景区：600米绿道示范段已形成	丹景台/ns
成都高新丹景台景区建设加快推进 600米绿道示范段已形成	成都/ns,丹景台/ns
稻城亚丁风景区主要由“仙乃日、央迈勇、夏诺多吉”三座神山	稻城/ns
泸沽湖徒步稻城亚丁：8名驴友1天被冰雹砸4次，缺粮挨饿吃树皮！	泸沽湖/ns,稻城/ns
聚焦｜德州市政府发文严抓房地产！这些信息将全部公开……	德州/ns
地球开启“震动模式”？我国台湾省、日本相继发生有感地震	日本/ns
美国8级强震，日本智利火山喷发，地球变得不稳定了吗？未来会不会有更大的灾难？	日本/ns
我国台湾、日本连续地震，仅仅是地球地震带的一点小动作？	日本/ns
地球这是怎么了？美国夏威夷群岛突发6.9级地震，游客紧急疏散！	夏威夷群岛/ns
地坛中医药健康文化节 尽显东城中医文化特色	地坛/ns
「改善医疗服务」全能高手外科医生，地坛再登场	地坛/ns
陕西紫阳东木镇切实做好强降雨核实和救助工作	陕西/ns,紫阳/ns,东木镇/ns
陕西紫阳县东木镇开展防汛防滑应急演练	陕西/ns,紫阳县/ns,东木镇/ns
邢台东市村1600余名村民被困洪水 消防官兵挺进一线	东市村/ns,邢台/ns
东营区实验学校召开“校园安全维稳”专题会	东营区/ns
东营市召开2018年普通高校招生考试安全工作会议	东营市/ns
北大清华自主招生初审名单公布 东营市29人上榜	东营市/ns
春季高考5月12日至13日举行 东营市在广饶一中设考点	广饶/ns,东营市/ns
2018池州东至县公务车辆管理服务中心招聘拟录公示	池州/ns,东至县/ns
从成自驾游来到珠海，去了一趟斗门清朝古街，你去过吗	珠海/ns
清醒 盘点俄红场阅兵这些武器装备中国尚属空白，同志仍需努力！	中国/ns,俄红场/ns
恩施有没有没开发的好景区？	恩施/ns
“恩施一日游”有什么好的路线推荐？	恩施/ns
5月，去恩施走走，八大景区将免费开放	恩施/ns
突发！一游客在恩施大峡谷突遇山体落石，景区发出公告	恩施大峡谷/ns
无限风光在险峰，全球最长最美丽的大峡谷之一湖北恩施大峡谷景区	恩施大峡谷/ns
恩施大峡谷落石毙命，暴雨天后尽量避免山野峡谷游！	恩施大峡谷/ns
泰州中航推出6月4/7月9日长江三峡神农架恩施五星游轮6日游2880元	恩施/ns,长江/ns,神农架/ns,三峡/ns
泰州中航推出6月2/7月7日长江三峡神农架恩施五星游轮6日游2880元	恩施/ns,长江/ns,神农架/ns,三峡/ns
5月19日，恩施州八大景区将免费开放，赶紧计划一下出发吧！	恩施州/ns
揭阳交警市区二大队提醒广大群众注意雨季出行安全	二大队/nt
丰宁草原，国家5A级景区，夏日平均气温为17.4℃，非常凉爽！	丰宁草原/ns
Waymo今年将在凤凰城正式推出自动驾驶打车服务	凤凰城/ns
Waymo计划年内在凤凰城正式推出无人驾驶打车服务	凤凰城/ns
凤凰涅槃——25载沉沦，我挣脱了糖尿病！	凤凰城/ns
张家界旅游攻略，大连到张家界凤凰五日游	凤凰/ns,大连/ns,张家界/ns
汶川大地震十周年 回访重灾区四川理县 凤凰涅槃浴火重生！	理县/ns
张家界旅游攻略，张家界凤凰五日游	凤凰/ns,张家界/ns
张家界旅游攻略，一起相约张家界凤凰四日游	凤凰/ns,张家界/ns
奉节有那些景区？	奉节/ns
五一过后的南京夫子庙景区，人少了但风景依然很美	夫子庙/ns
扶绥农村商业银行做好春耕金融服务工作	扶绥/ns,农村商业银行/nt
5、6月份福建人可以免费游览宁夏23家景区	福建/ns
福建人5月～6月到宁夏玩 4A级以上景区免门票	福建/ns
6月30日前游玩宁夏 福建人可以免23家景区门票	福建/ns
福建籍游客到宁夏凭身份证享23家4A级以上景区免门票	福建/ns
福建人，6月30日前游宁夏，这23家景区统统免门票！	福建/ns
好消息！福建人的身份又升值了6月30日前这些4A级景区免费玩	福建/ns
福建人的身份证“升值”啦！6月30日前这些4A级以上景区免费玩！	福建/ns
福建厦门海沧区开展防止海域新增养殖回潮宣传	福建厦门/ns
7天后，全国人民都要羡慕福州人！这些4A级以上景区全部免费玩！	福州/ns
富平县委宣传部对贫困户进行养殖技术培训	富平县/ns,委宣传部/nt
上联：同修富裕路，下联：如何对完美？	富裕路/ns
2018年新疆伽师县招聘事业单位辅助人员公告	伽师县/ns
安福县甘洛学校举行地震安全逃生演练	甘洛/ns
西安高陵公开征集“高陵农产品区域公共品牌”名称和LOGO设计方案	高陵/ns
高密市事业单位面向双一流高校择优招聘党政储备人15名	高密市/ns
防灾减灾丨高温台风有啥影响 杭州气象台请你免费听课	高温台/ns
济南高新区一售楼处现千人购房大军，咋回事	高新区/ns
高新区举办农产品质量安全暨蔬菜生产关键技术培训	高新区/ns
菏泽高新区组团参加2018年上海全国农产品博览会	高新区/ns
潍坊高新区公开招聘事业编制教师15名，同时引进骨干教师20名！	高新区/ns
海口国家高新区举办2018年首场靶向（技术工人）招聘会公告	高新区/ns,海口/ns
“台湾见闻”之高雄西子湾景区，头一次听说“疯狗浪”	高雄/ns
戈壁新城格尔木，中国唯一一个为“军人”而生的城市	格尔木/ns,的城市/ns
泰州中航国旅推出特价：499元5月14/21/28日厦门鼓浪屿六日游	鼓浪屿/ns
来鼓浪屿旅游就要打卡！特别是抖音上大火的土耳其冰淇淋大叔	鼓浪屿/ns
最新！鼓楼区共12所小学招生通告，施教区范围整理，持续更新中！	鼓楼区/ns
四川最贵的景区，票价是故宫的5倍，去过的人从来不会后悔！	故宫/ns
我国最“假”的旅游城市造出了“最假”的景区，门票是故宫的8倍	故宫/ns
十级地震检查，卯榫结构的故宫模型巍然屹立	故宫/ns
准备回家搞关中驴养殖，有什么好的建议吗？	关中/ns
郑州市管城区小李庄小学防灾减灾应急疏散演练隆重举行	管城区/ns
什邡消防推广安装独立感烟火灾探测报警器260个	广安/ns
关于2018年度粤桂扶贫协作广西部分旅游景区对广东籍游客门票减免优惠政策的通告	广东/ns
广东平远县最值得去的景区——五指石风景名胜区	广东/ns,平远县/ns
房贷提高首付，利率上调，对广元刚需有什么影响？	广元/ns
上联：贵山贵水迎贵客，怎么对下联？	贵水/ns
洋县桂峰村：发展土蜂养殖为贫困户酿造“甜蜜生活”	桂峰村/ns
桂林五日游	桂林/ns
桂林哪个景区好玩？	桂林/ns
桂林自驾游如何安排？	桂林/ns
安庆到桂林自驾游如何规划？	桂林/ns
到桂林旅游，你最想去哪个景区玩？	桂林/ns
为什么桂林漓江不像杭州西湖一样免费开放景区？	桂林/ns
桂林房地产情况怎么样？	桂林/ns
桂林：网约车车型标准 高于市区出租车	桂林/ns
等你退休后，如果让你选择广西柳州和桂林两座城市养老，你会怎么选择？	桂林/ns
桂林平乐事业单位公开招聘104人！赶紧告诉身边人~	桂林/ns
暴雨致桂林内涝车辆被淹多人受困被营救	桂林/ns
广西首个！桂平西山风景区向警察免费开放	桂平/ns,西山/ns
地理难倒文科考生！海口一中名师支招	海口/ns
从乌鲁木齐去海口自驾游，需要注意些什么？	海口/ns
海南自驾游，汽车可以从北海渡轮到海口吗？	海口/ns
从辽宁葫芦岛自驾游去海南海口，不走高速，想体验一下沿途风景，有什么路线推荐？	海口/ns
海口租房贵不贵，一个单间大概多少钱？	海口/ns
海南房产限购之后，为何海口、三亚房价居高不下？	海口/ns
海口交通部门要求违规网约车平台整改 滴滴或被罚3万元	海口/ns
海口哪里适合北方人居住养老？	海口/ns
上联：月落寒山寺，下联怎么对？	寒山寺/ns
“老骥伏枥”的-汉阳造步枪！	汉阳/ns
2018中国旅游日免费景点：5.19合肥周边免费旅游景区名单	合肥/ns
合肥继续实施商品房预售资金监管	合肥/ns
合肥未来哪些区域的房产更值得投资？	合肥/ns
合肥住房租赁出新规 实施商品房预售资金监管	合肥/ns
刚刚！合肥5月二手房最新报价出炉！看看你家的房子多少钱！	合肥/ns
合肥目前最低薪资多少，正常的薪资水平是怎样的？	合肥/ns
合肥一六八教育集团面向全国招聘中学教师	合肥/ns
一个月三千多工资在合肥能过什么样的生活？	合肥/ns
2018合肥庐阳区招聘工作人员资格复审公告	合肥/ns
2018合肥长丰县事业单位第一批招聘工作人员资格复审公告	合肥/ns,长丰县事业单位/nt
出行路上遇到小事故怎么办？河西堡交警蜀黍告诉你答案！	河西堡/ns
去广东河源游山玩水必去的几个景区，了解一下吧	河源/ns
河源未考驾照的赚到翻！这所驾校要搞大动作！	河源/ns
重装出击！红场阅兵武器一览	红场/ns
它才是红场阅兵最大看点 靠战绩让美国闭嘴	红场/ns
2018俄罗斯卫国战争胜利纪念日红场阅兵	红场/ns
俄罗斯举行红场阅兵-最好的战斗机队形飞越红场	红场/ns
大批“铁甲”打头阵，数十架战机压轴，红场阅兵将再现帝国辉煌	红场/ns
俄罗斯今日红场阅兵，普京“秀肌肉”！叙利亚战场武器成最大亮点	红场/ns
快来看！5月9日，俄罗斯红场阅兵海量装备提前曝光：全是大杀器	红场/ns
1945年苏联红场阅兵真实影像 一个方阵居然举着敌军旗帜	红场/ns,苏联/ns
红旗渠郭亮村自驾游几天比较好？	红旗渠/ns,郭亮村/ns
重庆红岩景区将按照国家5A景区的标准重新改造！	红岩/ns
重庆红岩景区将升级 按照国家5A级旅游景区改造	红岩/ns
宏村镇：探头下的小红旗 景区里的先行者	宏村镇/ns
下周末山西这些大景区统统免费！洪洞也有一家！不玩你就亏大了！	洪洞/ns
洪洞公安交警严查涉牌涉证等交通违法行为	洪洞/ns
洪江区今年为农民工讨回欠薪128万元	洪江/ns
给自己放一个草原假——呼伦贝尔五日游	呼伦贝尔/ns
呼伦贝尔美景在路上，免费的天然景区！	呼伦贝尔/ns
七月去呼伦贝尔六日自驾游，路线怎么选择？	呼伦贝尔/ns
呼伦贝尔大草原、额尔古纳、满洲里、漠河、北极村7日游	呼伦贝尔/ns
5·19中国旅游日！木兰花乡景区门票全免，首届大型绣球花节等您来赏！	花乡/ns
兵马俑+华清池一日游 小编冒死偷拍	华清池/ns
意欲何为？俄罗斯突然改变主意，主动售华新核潜艇，一次就是12艘	华新/ns
华州区打造首个明码实价示范景区	华州区/ns
华州区打造首个明码实价示范景区 投诉电话12358	华州区/ns
福利来啦！5.19中国旅游日，北京怀柔6个著名景区有惊喜！	怀柔/ns
黄龙景区培育出30多种兰科植物——杓兰	黄龙/ns
汶川大地震10周年 九皇山涅槃重生：溶洞里的黄龙 绝壁上的华山	黄龙/ns
乌鲁木齐到张家界森林公园+黄龙洞+天门山四日游	黄龙洞/ns,张家界/ns
黄龙溪谷别墅区，买一百赠一百，养老度假好去处，有钱一定买一套	黄龙溪/ns
5月黄山风景区优惠活动速览	黄山风景区/ns
黄山旅游攻略——黄山风景区概况及注意事项	黄山风景区/ns
黄山风景区推出“中国旅游日”1+6旅游惠民措施	黄山风景区/ns,惠民/ns
注意：云阳云开路305省道98KM500黄石段塌方 过往车辆注意安全	黄石/ns
北京西城区小升初报名通知：外区外省学生回西城就读须有房有户口	回西城/ns
「区县动态」汇川区畜禽养殖污染整治工作有序推进	汇川区/ns
惠民交警刑拘一无证醉驾致人死亡交通肇事犯罪嫌疑人	惠民/ns
公务员、事业单位工资调整文件，浑源为一类区	浑源/ns
现实中这把枪在北美大受欢迎 吃鸡里这是目前最强冲锋枪	北美/ns
天津蓟州区A级旅游景区15家 今年拟新增4家	蓟州区/ns
美国南加州发生4.5级地震无人伤亡 洛杉矶震感明显	南加州/ns
吸取火灾教训 嘉善消防联合多部门排查全县养老院	嘉善/ns
商场火灾报警系统存故障 嘉善消防责令限期整改	嘉善/ns
重磅！嘉兴18年中考时间和招生政策新鲜出炉，权威解答了解一下	嘉兴/ns
在嘉兴投资商住房产有价值吗？	嘉兴/ns
浙江嘉兴和浙江湖州哪个地方更适合投资房产？	嘉兴/ns
浙江嘉兴和浙江湖州，哪个地方更适合投资房产？	嘉兴/ns
陕西农村自建养老别墅，每平造价1400，上门参观者险将门槛踏破！	将门/ns
江苏泰州姜堰区签下全省首单农产品质量险	姜堰区/ns
河南焦作的云台山风景区如何？	焦作/ns
5.19中国旅游日 焦作青天河景区门票半价优惠	焦作/ns
焦作这所学校招聘33人，想当老师的赶紧看，福利待遇超赞！	焦作/ns
来河南省焦作市旅游，最不能错过的三大旅游景区	河南省/ns,焦作市/ns
介休的绵山风景区怎么样？	介休/ns
金华举行中小学防灾减灾应急演练	金华/ns
伊春金山屯：听说，母亲节这三家景区可以集赞换门票！	金山屯/ns,伊春/ns
甘肃金塔：开年首场雨，万物尽欢喜，交警忙提示！	金塔/ns
「直通校园」晋源区晋祠镇东庄中心小学校开展“防灾减灾日”活动	晋祠镇/ns,晋祠镇/ns,中心小学校/nt,中心小学校/nt
报名分析｜杭州经济开发区教师招聘竞争比最高28.5:1~	
景德镇六个4A级景区，精美绝伦	景德镇/ns
上联：望江东至景德镇，求下联？	景德镇/ns
瑞金九堡镇羊角小学切实抓好学生交通安全教育	九堡镇/ns
深圳农家乐一日游：你好，五月的九龙山	九龙山/ns
深圳农家乐一日游，亲子活动九龙生态农业园	九龙生态农业园/ns
上联：酒泉，怎么接下联？	酒泉/ns
酒泉无酒酒漂香，如何对对联？	酒泉/ns
上联：我居北海君南海；求下联	北海/ns
市中院居国屏院长深入九江县防汛一线走访慰问	
2018南京周边最美旅游度假景区！你知道几个？句容茅山高德庄园！	句容茅山高德庄园/ns
康乐县竹子沟旅游景区建设有序推进	康乐县竹子沟/ns
缅甸帕敢矿区再发山体滑坡 已致至少12人死亡	
成都包车去拉萨自驾游多少钱	拉萨/ns
从拉萨到乌鲁木齐自驾游走什么线路合理？	拉萨/ns
“世界屋脊明珠”西藏拉萨布达拉宫，世界文化遗产，国家5A级景区	拉萨/ns
蓝田县簸箕掌景区周末掠影之 宁静篇	蓝田县簸箕掌/ns
蓝田县2018年公开招聘高层次人才面试通知，附面试名单及参考资料！	蓝田县/ns
致敬无名英雄们：高清图片还原老山战役喋血瞬间（二）	老山/ns
假如乐陵是一个班级 这些景区将扮演不同“角色”	乐陵/ns
拆迁！真的会一夜成富吗？乐清南草洋赔偿标准出来了！	乐清南草洋/ns
贵州雷山举办农药经营人员培训助力绿色兴农	雷山/ns
占地351亩 榆中县李家庄棚户区改造项目（A地块）开始封顶	李家庄/ns
汶川大地震十周年 四川理县重新“复活” 山清水秀等你来玩！	理县/ns
鲤城交警开展夜查夜巡行动 严查交通违法行为	鲤城/ns
Aql与多家企业在利兹市开展自动驾驶及5G测试	利兹市/ns
你知道荔波大小七孔景区的区别吗	荔波大小七孔/ns
连云港云龙涧原生态风景区	连云港云龙涧/ns
从连云港到岳阳市自驾游玩，有什么好路线推荐吗？	连云港/ns,岳阳市/ns
4月份从连云港出发去郑州，自驾游如何选择路线？	连云港/ns,郑州/ns
连云港多家银行首套房贷利率上浮，部分银行暂停房贷……	连云港/ns,部分银行/nt,多家银行/nt
十年之变4 梁平之变：盒式教学楼 地震也不怕	梁平/ns
重庆梁平发生森林火灾 多山头起火烧足5小时	重庆/ns,梁平/ns
直击四川两大名人故里，都是免费的国家5A级景区，假期人山人海！	四川/ns
甘肃两当最美春耕图——你们才是主角！	甘肃/ns
不是所有兵都是人民子弟兵，对比汶川地震与美国飓风两国军队做法	汶川/ns
下联：聊城聊天聊聊城，如何对上联？	聊城/ns,聊城/ns
沐川县林业局与民同劳助春耕	沐川县/ns
林州、鹤壁，9大原生态、无门票景区，51自驾你选哪一个？	林州/ns
林州妇幼“孕妇瑜伽课堂”开课了	林州/ns
诗词里的林州太行大峡谷	林州/ns,太行/ns
河南灵宝：全面加强房产管理	灵宝/ns
冶河香玲牌核桃荣获济南市第一届“十佳最受欢迎品牌农产品”称号	冶河香/ns
说真话的刘绥滨大师！青城派掌门人亲历汶川地震：救人非武术强项	刘绥滨/ns
养老留城市好还是回农村好？	
上联：桃花伴柳江湖远，如何对下联？	柳江/ns
「好消息」2018年普高招生方案出炉啦！柳江区中考毕业生可报读市内任一高中啦！	柳江区/ns
柳林交警扎实开展农村道路交通安全管理工作	柳林/ns
「好消息」柳江区的初中毕业生可以报读柳州市区任何一所高中学校	柳州市区/ns,柳江区/ns
江西最值得去的5A级景区之一：鹰潭龙虎山有多少不为人知的秘密？	鹰潭龙虎山/ns
武汉首创公积金调额、深圳龙华22项目动工、恒大布局长租公寓	
五龙口景区迎来千人研学团队	五龙口/ns
全南县天龙山景区，打造生态康养旅游综合体	天龙山/ns
龙岩客家两日游，走过汀州古城，探访培田古民居，登顶连城冠豸山	龙岩/ns,连城冠豸山/ns
龙岩积极解决无过错购房人的登记办证问题	龙岩/ns
“相约强军新时代”网络名人进军营活动在龙岩举行	龙岩/ns
庐山市交警把交通安全带进校园	庐山市/ns
鲁山交警全力保障安全畅通，市县领导给予肯定	鲁山/ns
鲁山红河谷景区随拍	鲁山红河谷/ns
第二届石家庄市旅发大会6月9日至11日举行 6月鹿泉各景区可半价游	鹿泉/ns
连发8则公告！鹿泉区征地约78.13亩 均建设住宅	鹿泉区/ns
农田受损害 鹿寨县法院中渡法庭法官田间解纠纷	鹿寨县/ns,中渡法庭/nt
碌曲春耕备耕工作全面启动	碌曲/ns
罗布泊如何开发成旅游景区、国家公园，会有经济效益吗？	罗布泊/ns
元绿二级公路因山体滑坡中断 绿春公安交警为群众保驾护航	绿春/ns
超赞！麻城第一批共享单车已在这个景区投入使用啦！	麻城/ns
麻城没考驾照的人开始狂欢吧！国家一锤定音：马上执行	麻城/ns
马嵬驿和白鹿原旅游景区的游客为什么日益锐减？	马嵬驿/ns,白鹿原/ns
安徽毛坦厂镇各地学生就读 逾万家长陪读	毛坦厂镇/ns
安徽毛坦厂镇各地学生就读 逾万家长陪读（组图）	毛坦厂镇/ns
道家名山之青城山一日游攻略！	名山/ns
重庆旅游景点：鬼城丰都名山景区内奈何桥	名山/ns
赤峰招聘76名社区工作人员，大专也能报名！仅限赤峰户籍	名社区/ns
明水举办健康农产品扶贫产销对接会	明水/ns
魔都（上海）一日游	魔都/ns
云南省楚雄州牟定县：抓好春耕备耕 助力脱贫攻坚	牟定县/ns,楚雄州/ns
牟尼沟风景区林木遍野，大小海子可与九寨彩池比美	牟尼沟/ns
南都中医馆专家团应邀走进泰康人寿	南都/ns
南都中医馆：中医药文化传承要从娃娃抓起	南都/ns
南和交警持续整治大货车超限超载——严惩不贷！	南和/ns
唐山南湖景区免费开放 游客幸福感爆棚	南湖/ns,唐山/ns
南市村打造“农家乐” 建成后可供200人同时就餐	南市村/ns
大自然户外 户外新线路 南太行四景区连穿	南太行/ns
科普防灾知识演练应急疏散 南通举行应急救援综合演练	南通/ns
南通“防灾减灾进学校”现场演练举行	南通/ns,学校/nt
生生不息 南通支云发布汶川地震十周年海报呼吁赛前默哀	南通/ns
中超多家俱乐部海报纪念 汶川地震十周年，四川、南通赛前默哀	南通/ns,多家俱乐部/nt
南通六院：小儿中医大有作为	南通/ns
2018年南通市区高考考点安排出炉 原一中考点调整至通大附中	南通市区/ns
五一长假华中地区景区门票TOP10！南湾湖位居前三	南湾湖/ns
甘肃民乐与内蒙古阿拉善左旗开辟自驾游新路线	内蒙/ns
内蒙古呼和浩特是个适合养老的城市吗？	内蒙/ns,的城市/ns
招聘｜上汽乘用车宁德基地开工，一大波社招岗位呼啸而至！	宁德/ns
百名网络名人走进宁德：今天，我们和地震男孩在一起！	宁德/ns
全力推进牛头山5A级景区创建	牛头山/ns
贺乡村阿里平邑钉钉农场村之福牌蒙山黑羊肉上架利农可视化微商城	农场村/ns,平邑/ns,福牌蒙山/ns,阿里/nt
想在攀枝花买套房子渡假养老，应该如何做准备？	攀枝花/ns
南部新城新盘云湖府邸5月5日临时售楼处及样板间开放	盘云湖/ns
共享农庄引入共享观光车，畅行微车入驻湖南彭山景区	彭山/ns
消除火灾隐患 共建平安社区——青海“119”消防宣传周正式启动	平安社区/ns
四川平昌这个乡镇入选四川“十大最美茶乡”	平昌/ns
青岛新农人｜弃名校进职校，平度小伙返乡养猪	平度/ns
平桂区农业局三举措做好农产品质量安全监测工作	平桂区/ns
平乡又现“炸街小摩托” 交警表示“绝不手软”	平乡/ns
平阳镇全方位服务大田播种工作	平阳镇/ns
历史文化古城、世界文化遗产、平遥古城为啥为5A风景区	平遥/ns
大田县屏山乡茶美人景区生态茶园茶农采茶忙	屏山乡/ns
重庆飞普吉岛6日游只要999元？业内人士：经济舱单程就要1500多	普吉岛/ns
重庆飞普吉岛6日游只要999元？业内人士：经济舱单程就要1500多元	普吉岛/ns
七星关区对坡镇：“春风行动”落实处 养殖产业助增收	七星关区/ns,对坡镇/ns
「齐鲁营养」手术病人补营养，光喝鸡汤可不行	齐鲁/ns
上联：乌鲁木齐齐齐哈尔，怎么对下联？	齐齐哈尔/ns
淄博齐山风景区再放大招 519请全国人民免费游齐山	齐山/ns
奇台江布拉克二日游	奇台江/ns
上联：千里黄河水涛涛，下联如何对？	黄河水/ns
前门一日游	前门/ns
细数前苏联著名飞机设计局，今又几何在？	前苏联/ns,飞机设计局/nt
深度揭秘：前苏联通灵部队曾预测到地震？还感应到核爆危险？	前苏联/ns
乾县“激情省运 逐梦乾州”省运会倒计时100天暨第六届文化养老艺术节开幕	乾州/ns
「纪念"5.12"汶川地震10周年」旅游业成为硗碛支柱产业	硗碛/ns
定了！下周六秦皇岛16家景区免费、打折！	秦皇岛/ns
扩散｜5月19日秦皇岛这些景区门票免费或半价！	秦皇岛/ns
再等一周！5月19日去秦皇岛这些景区至少省一半的钱！	秦皇岛/ns
秦皇岛在京举行“名校英才入秦”招聘会	秦皇岛/ns
原创诗词：（七律）过秦始皇陵	秦始皇陵/ns
学书法有助疗养？清波街道办了场特殊的书画展	清波街道/ns
清朝火器天才造出最强火炮，却被诬陷流放！他若不死大清不会亡	清朝/ns
清朝士兵衣服前的“兵”与“勇”，字不一样地位更是天壤之别！	清朝/ns
重要提醒！阜阳市第三人民医院招聘考试相关通知	阜阳市/ns
2018阜阳市第五人民医院招聘调整考试时间公告	阜阳市/ns
2018宣城宁国市人民医院招聘入围面试人员名单（第一批）	宁国市/ns,宣城/ns
昌乐县人民医院 2018年度护士招聘简章	昌乐县/ns
甘肃省第二人民医院药膳食疗验方——糖尿病1	甘肃省/ns
甘肃省第二人民医院大量开展TIPS治疗让更多患者受益	甘肃省/ns
眉山市畜牧局督查仁寿沱江流域畜禽养殖污染问题整改情况	眉山市/ns,仁寿/ns
任城交警大队开展“畅行中国 交警同行”宣传活动	中国/ns,任城/ns
2018年春季高考日照3416人报考 设3个考点	日照/ns
山东日照浮来山景区	日照/ns
山东日照万平口风景区	日照/ns
囊括日出、日照金山、星空、云海的景区，只有这里有！能认出来嘛	日照/ns
泰州中航国旅推出日照赶海拾贝、海鲜大咖大樱桃采摘二日游288元	日照/ns
上联，日照花似锦，下联怎么对？	日照/ns
上联：日照西湖映断桥，如何对下联？	日照/ns
上联:日照日照日出日照，有什么下联？	日照/ns
最近网上空姐被网约车主害案，日照网约车开始办大事了	日照/ns
日照万平口景区怎样运营的更好？	日照/ns,万平口/ns
汶川地震10周年，全球最大的十次地震，逝者已矣 生者如斯英语	汶川/ns
赛里木湖景区好玩吗，有啥特色？	赛里木湖/ns
赛里木湖景区区间车“赛湖号”开始试运行	赛里木湖/ns
赛里木湖景区区间车本月试运行 免费乘坐！	赛里木湖/ns
广水三潭风景区好玩吗？是否值得一去？	三潭风景区/ns
中国公布核武使用“三原则”, 一旦越线，百倍反击！	三原/ns
“暖春·援梦”关爱高考生龙江高校大型公益巡讲第二季第三站走进大庆	三站/ns
2018高考生！山大、海大等山东九大院校综招重点报考信息看这里！	山大/ns
山东10所高校试点综合评价招生 山大海大招生计划增加	山大/ns
山西太原市的高校有哪些？都分布在哪里？	山西太原市/ns
山西太原市的高校有哪些，都分布在哪里？	山西太原市/ns
善南街道清华园小学开展防震减灾手抄报评比活动	善南街道/ns
火州吐鲁番鄯善沙漠一日游	鄯善沙漠/ns
陕西商洛：柞水交警严查酒驾取实效，两月查获酒驾53起	商洛/ns,柞水/ns
「淀山湖上海湾三期」「售楼处」「官方网站」	上海湾/ns
第十四届中国（深圳）文博会上河东文化受热捧	上河东/ns
坐着中国最早自主设计制造的索道上崂山仰口景区	上崂山/ns
邵东十万亩生态养殖 德美肉羊唱主角	邵东/ns
惊！南京江北核心区华润国际社区 有二手房挂牌要卖5万/㎡	社区/ns
2018天津市和平分局招聘社区戒毒、社区康复工作人员成绩查询入口	社区/ns,和平分局/nt
申城4月二手房成交明显下降，为近六年同期新低	申城/ns
武汉到神农架两日游怎么样？	神农架/ns
浉河区一小举行“法制安全教育”主题升旗仪式	浉河区/ns
覆盖十区，共招936人！深圳市公办中小学2018大规模招聘正编教师	十区/ns
好消息！十堰市直学校招聘体育教师面试成绩出炉	十堰/ns,市直学校/nt
新化石冲口镇中心小学开展“预防校园欺凌”安全教育活动	石冲口镇/ns,新化/ns
石鼓镇这名妇女养猪年收入近20万	石鼓镇/ns
石家庄夏季有休闲避暑的景区吗？	石家庄/ns
石家庄滹沱河景区今后怎样发展？	石家庄/ns
谁知道河北省石家庄的驼梁景区怎么样？谁去过啊？	石家庄/ns
在石家庄，手头有20万，该买房还是租房？	石家庄/ns
在石家庄购买二手房时有哪些需要注意的地方？	石家庄/ns
石家庄4月份二手房房价出炉，快看你家涨了还是降了？	石家庄/ns
石家庄79个旧城改建项目的拆迁、补偿、安置方案公布！	石家庄/ns
2018年第一季度石家庄房地产市场分析报告新鲜出炉！	石家庄/ns
定了！石家庄79个旧城改建项目的拆迁、补偿、安置方案公布！	石家庄/ns
石家庄棚户区改造新政！2020年完成 94大棚改项目这么处理	石家庄/ns
参照石家庄的房价，一个月多少工资才能有保障？	石家庄/ns
世界罕见，堪称“中华自然奇观”的甘肃黄河石林一日游	石林/ns
石林县所属事业单位公开招聘工作人员	石林县/ns
邯郸交通广播古石龙景区烧烤采摘节来啦～	石龙/ns
省市各级媒体竞相报道，石门栈道风景区到底有何魅力？	石门/ns
“5·12”地震十周年｜成都部分市县及周边市州灾后重建景点新风貌！	市州/ns
献爱白衣天使和伟大母亲，寿光这些景区有优惠！	寿光/ns
寿光市境内旅游景区介绍	寿光市/ns
寿宁“白鹤仙岩顶”景区	寿宁/ns
关注！下周起，安徽舒城及周边一大波景区降价优惠啦！	舒城/ns
连城双达农场桃园“黄金桃”采摘继续进行中！	双达农场/ns
旅游景区双浮镇 是一座历史悠久的千年古镇	双浮镇/ns
2018年5月12日商丘市梁园区水池铺乡辣椒农户生产种植实况	水池铺乡/ns
水磨镇涅槃重生 工业重镇成功转型康养旅游景区	水磨镇/ns
看水磨镇涅槃重生 工业重镇成功转型康养旅游景区	水磨镇/ns
泰州中航旅游推出常州中华恐龙园、迪诺水镇一日游248元	水镇/ns
斯巴达的三百勇士在温泉关打败波斯军队了吗？	斯巴达/ns
杭州宋城景区	宋城/ns
泰州中航推出西塘全景、漫步西湖、宋城千古情深度二日游298元	宋城/ns
万科新养老项目随园·长阳8月面市	随园/ns
河南一景区，被誉“太行之魂”，却因连环交通费，遭游客吐槽太坑	太行/ns
紫霞关古道奇峰，秒杀太行A级景区，媲美张家界，无门票	太行/ns,张家界/ns
对接帮扶订单养殖 泰和走出产业脱贫新路子	泰和/ns
唐口这个养殖大户农牧循环、种养结合，有本生态经	唐口/ns
最高上浮20%！唐山学生和家长注意，河北这些大学及专业学费拟调整！	唐山/ns
唐山：防灾减灾宣传活动走进小学校园	唐山/ns,唐山/ns
改印象 树形象 明方向 唐山世园会会址南湖景区免费开放	唐山/ns
唐山这些地方要进行棚户区改造、危旧平房改造，招标公告发布！	唐山/ns
唐山无人机“黑飞”，惊动空军起飞，4人被批捕！	唐山/ns
唐山没考驾照的人狂欢吧！国家一锤定音：马上执行！	唐山/ns
唐山学院招聘 无笔试，录用即入编！安家费+津贴+租房补助！	唐山/ns
月工资多少人可以在唐山买房？	唐山/ns
唐山大地震有前兆，汶川地震的时候有前兆吗？	唐山/ns
唐山大地震震级比汶川地震小，为何伤亡要大许多？	唐山/ns
唐山大地震系列之《生命的价值》	唐山/ns
预警楼市泡沫，从唐山大地震中学到啥？	唐山/ns
中国首次濒死调查：唐山大地震还阳者看到地下宫殿听到生死簿	唐山/ns
为保设备奋战48小时——北京铁路局唐山供电段职工抗击暴雨纪实	唐山/ns
唐山路北区要重点整治在职教师有偿补课的行为，你怎么看？	唐山路/ns
全民参与！评选中国十大自驾游目的地，谁才是你心中的桃花源？	桃花源/ns
全民参与！评选中国十大最佳自驾游目的地，谁才是你心中的桃花源？	桃花源/ns
南充有个世外桃源景区 风景堪比马尔代夫	桃源/ns
滕州教育局给所有家长写了一封信 严惩有偿补课	滕州/ns
滕州家长注意新谣言：100元感谢费骗孩子上车带路？	滕州/ns
滕州教师城乡轮岗、招聘先面试再笔试、乡村教师宿舍纳入保障房	滕州/ns
纪念汶川地震十周年——重温天安门广场那个令世人震撼的午后	汶川/ns,天安门/ns
想去天津一日游，天津站附近有什么好吃的和好玩儿的地方？	天津/ns,天津站/ns
湖南张家界天门山，栈道玻璃桥，国家AAAAA级景区，世界自然遗产	湖南/ns,天门山/ns,张家界/ns
「房管家」在龙城天水选择这样的房子 你可以多拿一份工资！	龙城/ns,天水/ns
想要买房养老，宝鸡和天水哪个更有发展潜力呢？	天水/ns,宝鸡/ns
重庆万盛遭遇64万方滑坡险情 地面裂缝宽比拳头	万盛/ns
济源王屋山风景区游记随拍	王屋/ns
锡林浩特市2018旅游季活动启动仪式暨中国马都马文化广场系列活动——幸运观众亲子采摘半日游欢乐落幕	文化广场/ns
闻喜交警送《交通安全劝导手册》进农村	闻喜/ns
土耳其桑尼乌法遭遇洪水 约50座房屋被毁	桑尼乌法/ns
五常凤凰山景区吃住玩怎么样？	五常/ns
强降雨致湖北五峰道路塌方 多处路段中断	五峰/ns
预算3万，一家五口自驾游，时间7天，浙江周边的省市有哪些推荐？	五口/ns
山东日照五莲山风景区	五莲/ns,日照/ns
「成都教育事」计划学位总数1840人！2018年武侯区24所教办幼儿园招生公告出炉	武侯区/ns
2018年5月重庆武隆仙女山自驾游需要注意的几个问题	武隆/ns
武威汉代医简方药注解及临床运用（七）第二十三期讲座	武威/ns
武威汉代医简方药注解及临床运用（六）第二十二期讲座	武威/ns
武穴本土旅游商品亮相当地各大景区	武穴/ns
湖北武穴本土旅游商品亮相当地各大景区	武穴/ns
上联：江中鱼东游西藏，下联怎么对？	西藏/ns
2018广西教师招聘备考：这些西方教育家常常考~	西方/ns
西乡塘区华强街道开展在卫国小学组织开展“远离毒品 珍爱生命”禁毒宣传教育主题班会	西乡塘区/ns,街道/ns
迎双节，曲阜仙河花海景区门票免免免！	仙河花海/ns
湖北西部一个县，名字却包含“东”字，拥有5A级旅游景区	县/ns
今年黑龙江16个县开展水稻机插秧集成活动 示范同步侧深施肥技术	县/ns
凤县交警：深入太（白）∽凤（县）高速项目部宣传交通法	县/ns,高速项目部/nt
大地震后重建的中国最大的羌族聚居县，山清水秀风光美	县/ns
贵州：沿河县教育系统积极开展防灾减灾宣传教育	县/ns
邯郸大名20万斤西瓜滞销瓜农愁 县电视台为民解忧寻销路	县/ns,大名/ns
兴山县县人民医院招聘公告	县/ns,人民医院/ns
挺进映秀——军事记者相军汶川大地震抗震救灾亲历纪实	汶川/ns
5月8日杭州（主城、萧山、余杭、富阳、临安）商品房成交列表	萧山/ns,余杭/ns
京北一日游——京北有个小洛阳：延庆的“四季花海”	小洛阳/ns
湖北多地调整公积金、房贷政策！襄阳宜昌黄石孝感十堰看过来！	孝感/ns,黄石/ns
辛店街道康都家园幼儿园开展“健康生活，拒绝垃圾食品”食品安全主题教育活动	辛店街道/ns,康都家园幼儿园/nt
田间喷洒农药的“无人机”大显身手、事半功倍！辛集老兵视线	辛集/ns
街镇动态丨辛口镇“五个早到位”提前备“三夏”	辛口镇/ns
甘州区新墩镇大力培植“土专家”促设施农业发展	新墩镇/ns
甘州区新墩镇认真做好耕地地力保护补贴信息核实及发放工作	新墩镇/ns
顺庆区新复乡七坪寨景区	新复乡/ns
新华中路东段片区新增73.2亩用地 地块由杰东房地产自行改造	新华中路/ns
新会区2018年教育卫生系统公开招聘事业单位职员笔试成绩查询进行中	新会区/ns
新会区2018年教育卫生系统公开招聘事业单位职员笔试合格分数线	新会区/ns
新疆江布拉克景区万亩麦田穿雪白外套	江布拉克/ns
新疆江布拉克景区万亩麦田“穿”雪白“外套”	江布拉克/ns
山东新泰交警走进物流货运公司宣传交通安全	新泰/ns,物流货运公司/nt
海沧区新阳街道征兵宣传进军营 青年从军热情高	新阳街道/ns
新洲乡：永存村着力解决地租拖欠问题	新洲乡/ns
河南省十大最具影响力景区 洛阳三处上榜 信阳黄柏山第十	信阳/ns,黄柏山/ns
信阳这个景区牛了！冲进了河南省最具影响力十大景区排行榜！	信阳/ns,黄柏山/ns
河南省十大最具影响力景区 嵩山少林景区第一 信阳黄柏山第十	信阳/ns,黄柏山/ns
「喜讯」超优惠！信阳这些景区母亲节“大放价”！快带上妈妈这周末走起~	信阳/ns
豫南信阳：立夏过后插秧忙	信阳/ns
信阳明港交警：紧急避让致侧滑甩尾 大车冲进路边民宅	信阳/ns
信阳浉河区双井办事处：念好“三字经”打造平安校园	信阳/ns,浉河区/ns
信阳新校区紧急招聘老师数名！	信阳/ns
兴义丰都小学开展防震疏散演练 2分钟内千名师生安全撤	兴义/ns,丰都小学/nt
山东省胸科医院招聘合同聘用制工作人员48人公告	胸科医院/ns
雄安雄县招聘中小学（幼儿园）教师650名！	雄安雄县/ns,中小学/nt
熊本大地震的烈度与东日本大地震相同？	熊本/ns
熊本大地震后的思考---地震 核电 天灾人祸	熊本/ns
熊本特大地震是日本系列大地震的开始？	熊本/ns
宿迁：让小农户“搭上”现代农业“快车”	宿迁/ns
江苏宿迁农村该如何去创业？小龙虾养殖为创业首选值得大家借鉴！	宿迁/ns
南京鼓楼集团宿迁人民医院招聘护理70人	宿迁/ns,人民医院/ns
秀龙潭景区，原汁原味美到不行，40元一天管吃住，还不用买门票	秀龙潭/ns
从河南许昌到浙江杭州自驾游都经过哪些主要景点？	许昌/ns
雪乡再爆宰客事件，你还会去雪乡旅游吗？	雪乡/ns
雪乡印象，虽然屡屡出现宰客丑闻，风景确实很美	雪乡/ns
烟台3万余人参加夏季高考 全市共设27个高考考点	烟台/ns
烟台3万余人参加高考，27个考点已公布！	烟台/ns
从烟台出发，自驾游有哪些好的路线推荐？	烟台/ns
烟台威海青岛三日游，最后青岛坐飞机回去，有哪些景点推荐？	烟台/ns
烟台农机购置补贴政策调整 每户年最高可享补贴一百万	烟台/ns
烟台栖霞这个产业园很重要，关乎十万多名果农的切身利益	烟台/ns,产业园/ns
砚山县维摩乡倮何腻村委会开展技术培训助推产业发展	砚山县/ns
燕赵新韵惊艳深圳文博会	深圳/ns
山东阳信：现代合作养殖助力精准扶贫	山东/ns,阳信/ns
华西旅游俱乐部神奇缅甸6日游火热征集中 3888元一价全含0自费畅玩缅甸仰光、勃固、维桑海滩	缅甸/ns,华西/ns,仰光/ns,旅游俱乐部/nt
瑞昌：多个养殖场粪便直排 田地河水遭污染	瑞昌/ns
如何建造既能节约成本又符合《中华人民共和国畜牧法》的养殖场？	中华人民共和国/ns
区农林局督查长风乡规模养殖场畜禽废弃物资源化利用工作	长风乡/ns
太原市晋源区姚村镇北邵小学 举行了“夏季安全教育”主题升旗仪式	姚村镇/ns
人间瑶池-黄龙景区	瑶池/ns,黄龙/ns
沙特战机空袭也门总统府遭报复 胡赛武装猛射多枚导弹还击	也门/ns
雅安市交警直属一大队开展道路排查活动	一大队/ns
贵州一个市所有景区对游客免费，贵州旅游缘何热衷于免费？	一个市/ns
日本士兵誓死效命的天皇，为了一口粮食，却如此不堪，让士兵心寒	一口/ns
黑龙江一林场因雷击起火 武警出动直升机灭火	一林场/ns
「急！」五河县小溪镇一农场桑葚滞销，果农渴盼援手！	一农场/ns,小溪镇/ns
河北一市约谈滴滴 要求立即停止违规经营行为	一市/ns
一条青海——甘肃自驾游线路带给你！	一条青海/ns
你所说的是真的么？美航母打击叙境内伊斯兰国组织 舰长证实了	伊斯兰国/ns
万承奕：小学毕业的义乌枣农 让省农科院的专家刮目相看	义乌/ns,万承奕/nr
只有小学毕业的义乌枣农，培育出鲜枣新品种获得省农科院点赞	义乌/ns
关于易水湖景区大坝码头恢复营业的公告	易水/ns
最新！银川教育局通知，涉及招生、划片、入学年龄等！	银川/ns
中卫，银川三日游	银川/ns
银川房产经纪人10大酷刑，你中招了吗？	银川/ns
最新！银川新房、二手房每平价差500元！兴庆最贵，6***	银川/ns
英国人试图重新发明坦克：世界首台塑料战车亮相 颠覆你的认知	英国/ns
吸取教训 举一反三 迎泽区紧急开会部署火患排查	迎泽区/ns
汶川大地震把映秀镇夷为平地，废墟中国旗飘扬，国旗在家在！	映秀镇/ns
尤溪九阜山自然保护区实现建区17年无森林火灾	尤溪/ns,阜山/ns
尤溪县人武部组织民兵应急分队集中训练	尤溪县/ns,人武部组织民兵应急分队/nt
厦门人福利来啦！闽籍游客5、6月游宁夏4A级以上景区门票全免！	宁夏/ns
福建籍游客5、6月游宁夏4A级以上景区门票全免	宁夏/ns,福建/ns
福建籍游客夏季游宁夏 23家4A级以上景区免门票	宁夏/ns,福建/ns
5月1日~6月30日福建籍市民游宁夏23家景区门票免费	宁夏/ns,福建/ns
余杭208个小区二手房最新成交价公布！万元房还能找到吗？	余杭/ns
渔湾风景区	渔湾/ns
如何看待“广西玉林两名学生考上清华北大，每人获奖20万元”此类现象？	玉林/ns
广西玉林到三亚自驾游攻略？	玉林/ns
广东广西贵州自驾游记—D2 玉林谢鲁山庄-柳州尝荔枝	玉林/ns,鲁山庄/ns
玉屏2000万条茶籽芽忙嫁接	玉屏/ns
2018玉树又地震了	玉树/ns
青海玉树突发5.3级地震，影响有多大？	玉树/ns
青海玉树发生6.2级地震 青海消防总队玉树支队已做好出动准备	玉树/ns
青海玉树州称多县发生5.3级地震	玉树/ns,称多县/ns
青海玉树州发生5.3级地震	玉树州/ns
上联：西江月下西江美，如何对下联？	月下西江/ns
全球公认名誉最好的景区：月牙泉上榜，最后一个让你意想不到	月牙泉/ns
挖掘旅游潜力 敦煌月牙泉镇发展农家乐337家	月牙泉镇/ns
长沙岳麓区106名学生染艾滋病！请保持所有爱的纯净！	岳麓区/ns
忻州风景：忻州市云中河景区	云中河/ns
下周末，山西47个大景区免费！运城有10家···	运城/ns
消防头条防灾减灾宣传日 运城消防在行动	运城/ns
曝光！运城这三家单位存在重大火灾隐患	运城/ns
陕西柞水交警：重点交通违法行为集中整治持续发力	柞水/ns
沾益区：驻村队员送桌椅 助力脱贫攻坚工作	沾益区/ns
张家界天门山一日游	张家界/ns
长沙～张家界，小假3日游	张家界/ns
张家界旅游攻略，张家界天门山一日游	张家界/ns
张家界森林公园+大峡谷玻璃桥三日游	张家界/ns
张家界旅游攻略，张家界森林公园三日游	张家界/ns
张家界旅游攻略，上海到张家界森林公园二日游	张家界/ns
张家界旅游攻略，张家界森林公园+天门山二日游	张家界/ns
张家界旅游攻略，张家界森林公园+天门山三日游	张家界/ns
张家界旅游/自助游/自由行/自驾游最佳看景时间	张家界/ns
张家界旅游攻略，美女带你玩转张家界天门山一日游	张家界/ns
张家界旅游攻略，与美女相约张家界森林公园二日游	张家界/ns
张家界旅游自驾游、自驾车、火车、飞机航班路线指导	张家界/ns
张家界旅游攻略，难忘的张家界森林公园+天门山三日游	张家界/ns
张家界旅游攻略，相约张家界大峡谷玻璃桥+天门山二日游	张家界/ns
张家界国家森林公园两日游，要怎么样的路线，住宿求推荐	张家界/ns
张家界旅游攻略/自助游/自由行/自驾游最合适的行程路线	张家界/ns
张家界有哪些值得游玩的地方？有哪些世界之最？自驾游攻略	张家界/ns
最近几天到张家界，需要带什么衣服（自助游/自驾游/自由行）	张家界/ns
天津少年一人敢独闯张家界，再不疯狂就老了，萌化景区千万少女心	张家界/ns
张家界超级实用的张家界旅行攻略，张家界自驾游需不需要请导游？	张家界/ns
重庆到张家界自驾游，玻璃桥+玻璃栈道四天三晚行程应该如何安排？	张家界/ns
张家界大峡谷的B线和C线有什么区别？（自助游/自由行/自驾游）	张家界/ns
张家界自驾游，森林公园（武陵源）+天门山国家森林公园三日游	张家界/ns,天门山/ns,武陵源/ns
张家口统计局权威发布2017年房地产开发销售情况	张家口/ns
「重要消息」张家口个人住房公积金帐户余额可直接用于偿还公贷！	张家口/ns
张家口房价以什么为支撑，没有大型工业企业，工资都在3-4千之间，房价1.5？	张家口/ns
张家口消防检查10家加油站 整改火灾隐患18处	张家口/ns
章丘一日游之百脉泉公园	章丘/ns
母亲节，章丘这个景区女性可享半价优惠！	章丘/ns
福州连江琯头一日游：长门村中游，曲径通桃源	长门村/ns,通桃源/ns
假如美国控制中东地区，将会对世界经济军事产生何种影响？	中东/ns
中国史上有哪些著名的军事天才？	中国/ns
「小壹分享」中国式养老父母追随儿女进城成为“老年漂”	中国/ns
2018安徽省阳光人寿安庆中支招聘正式编制人员6人公告	中支/ns
南京最后一站——钟山风景区：在灵谷寺遇暴雨	钟山/ns,一站/ns,钟山/ns,一站/ns
周口一村庄杨絮着火，对付杨絮用啥方法好呢？	周口/ns
周宁：主动脉血管平滑肌细胞硬化是高血压治疗的新靶点	周宁/ns
同分值怎么录取 180分如何分配？周至县民办初中招生面谈评分标准	周至县/ns,民办初中/nt
泰州中航国旅推出华东五市+周庄+乌镇5日游1280元	周庄/ns
诸城32个小区房价出炉！看看诸城的二手房行情如何？	诸城/ns
解密：山东密州春酒缘何被诸城博物馆收藏	诸城/ns
「要闻」庄浪县组织收听收看全国及全省普通高校招生安全工作电视电话会议	庄浪县/ns
资溪交警公布5月份辖区低速车逾期未检验名单	资溪/ns
资溪：院长曾胜龙深入马头山林场指导防汛工作	资溪/ns
一场及时大雨滋润大地，资阳的农民朋友正忙着耕田插秧！	资阳/ns
资阳市学校防灾减灾应急宣传教育活动启动	资阳市/ns,资阳市/ns
滋贺县开始修复遭去年台风危害的彦根城外壁	滋贺县/ns,彦根城/ns
梓潼：前四个月商品房销售面积同比增长63.13%	梓潼/ns
宏观调控持续发力 自贡多管齐下调控房地产市场	自贡/ns
5月14日至5月20日 邹城这些景区对女性免费开放	邹城/ns
邹城农产品区域品牌名称全球创意征集大赛，召唤有创意的你！	邹城/ns
河北遵化廉政文化进景区	河北/ns,遵化/ns
驻马店市第十一小学 开展食品安全教育活动	驻马店市/ns,第十一小学/nt
驻马店：确保2018年高考各项工作安全平稳有序实施	驻马店/ns
郑州市二七区王庄小学防震逃生安全疏散演练隆重举行！	郑州市/ns,二七区王庄小学/nt
郑州航空港区湾王小学防震减灾安全疏散演练活动扎实、有效！	郑州/ns,港区湾王小学/nt
张店区南定小学积极参加2018年全省中小学安全文化建设现场研讨会	张店区/ns,南定小学/nt
沅江凌云塔学校2000学生开展防溺水及安全疏散活动	沅江/ns,凌云塔学校/nt
鱼台福田学校开展食品安全自查活动	福田/ns
校园氛围积极向上！上蔡县黄埠一中举办安全教育主题活动	上蔡县/ns
咸阳旬邑县司法局举办校园安全教育法治讲座	咸阳/ns,旬邑县司法局/nt
南阳市体育局精准扶贫“防溺水”安全教育走进寺湾镇小	南阳市/ns,寺湾镇/ns
南宁经开区教育系统防溺水安全教育扎实有效开展	南宁/ns,开区/ns
娄底市第一职业中学开展关爱生命健康防溺水安全教育宣讲	娄底市/ns,第一职业中学/nt
聊城召开2018年普通高校招生考试安全工作会议	聊城/ns
聊城市2018年普通高校招生考试安全工作电视会议召开	聊城市/ns
开封市二师附小举行“5.12”防灾减灾安全教育活动	开封市/ns,开封市/ns,二师附小/nt,二师附小/nt
九江双语实验学校幼教部开展防溺水安全教育活动	九江/ns,双语实验学校幼教部/nt
经开区龙背中心校开展防溺水安全知识专题教育活动	开区/ns
郏县新城中学举行“珍爱生命 预防溺水”安全教育及大型签字活动	郏县/ns,新城中学/nt
广元市利州区民族小学开展消防安全应急演练活动	广元市/ns,利州区民族小学/nt
恩阳区花丛小学举行女生青春期健康教育及安全教育讲座	恩阳区/ns
多措并举！上蔡县六小加强预防溺水安全教育	上蔡县/ns
东营为2018年普通高校招生考试安全做准备工作	东营/ns
大庆组织收看全国及全省高考安全电视电话会议	大庆/ns
慈利县组织收看收听全国高考安全工作电视电话会议	慈利县/ns
创平安校园 合江中学3000多师生饮上安全健康直饮水	合江/ns
“国家免费医学生”海南计划招生140人 只收农村生源	海南/ns
“教师的点拨不够高，会限制学生想象力”——名师重庆论剑教学	重庆/ns
昨天上午召开的会议！2018年江苏高考看这里……	江苏/ns
昨日今晨，潍坊的重要教育资讯	潍坊/ns
昨日暴雨未停课 厦门教育局要求加强住宿学生管理	厦门/ns,厦门/ns
“听说你们英国留学生都身价百万？”我自己怎么不知道……	英国/ns
最新消息！安徽出台中小学招生方案，家长们可要仔细看哦……	安徽/ns
最新数据！2018全国近三千人被清华北大降分录取！湖南数据抢眼！	湖南/ns
最新！重磅！安徽这6所高校纳入一本招生（附名单）	安徽/ns
最新！镜湖区政务区2018学区公布！你家孩子要上哪个学校？	镜湖区/ns,政务区2018学区/nt
最新！安徽多所高校纳入一本招生（名单）	安徽/ns
“中国第一考王”现年50岁，参加过21次高考，如今还在努力学习！	中国/ns
“中国十大名校”的词条发生这些之后  被封了！	中国/ns
「“三园”学校建设」正阳小学：育学生正气 造阳光校园	三园/ns,正阳/ns
「2019考研」如何选择适合自己的在职研究生专业/无锡宜兴MBA培训	无锡/ns,宜兴/ns
「奔走相告」准格尔旗2018沙薛两镇幼儿园秋季划片招生传来最新消息	准格尔旗/ns,薛两镇幼儿园/nt
「滨海发布」最全！滨海新区初中招生学片划分来了（附咨询电话）	滨海/ns,滨海新区/ns
最高加20分，还可破格录取！2018广东高考加分政策出炉！	广东/ns
「高考」高考志愿填报如何避免“高分低入”？滨州日报特邀专家来滨支招	滨州/ns
「工匠师生」意不意外？惊不惊喜？相不相信？南京这所职校175名学生通过本科省控数线	南京/ns
「公告通知」长沙市周南秀峰学校2018年直升生名单公示	长沙市/ns,周南秀峰学校/nt
综合评价招生报名开始了，山东5省属高校发布招生简章	山东/ns
综合评价招生报名开始！山东5省属高校发布招生简章	山东/ns
「聚焦」驿城区教体局召开2018年高考冲刺暨安全工作座谈会	驿城区/ns
子墨老师跟大家聊聊东莞2018名校自主招生学霸都出自哪些高中？	东莞/ns
「快讯」兴县收听收看2018年全国普通高校招生考试安全工作电视电话会议	兴县/ns
「扩散」青岛市区2018年幼儿园招生方案出炉！附最新收费标准……速收藏	青岛/ns
「留考攻略」如何才能通过日本留学生考试？	日本/ns
淄博中学举行冲刺高考特别升旗仪式	淄博/ns
「权威发布」黑龙江省2018年普通高校招生录取批次设置说明	黑龙江省/ns
资讯丨重庆共招150人！单独划线，提前批录取！国家免费医学生招生计划出炉！	重庆/ns
资讯丨2018广东高考考什么？如何考？敲黑板啦	广东/ns
「十年」高考将至 四川剑门关中学高三学子学习用品堆满过道	四川/ns
「填空题速解」2018厦门市高三理科毕业班5月质检	厦门市/ns
「喜讯！」淄博7人通过清华北大2018自主招生初审！	淄博/ns
「小司推荐」沧州｜毕业生档案邮寄地址在这里！	沧州/ns
「邀请函」第二届陕西区域MBA院校教育展暨2019年招生政策发布会	陕西/ns
「有线课堂」高考倒计时！山东有线互动点播新东方学堂，助你斩高分，赢高考！	山东/ns
「有线课堂」高考倒计时一个月！山东有线互动点播新东方学堂，助你斩高分，赢高考！	山东/ns
「招考快递」你知道2018年南京市高中阶段学校（含职业学校）考试招生工作是怎么安排的吗？	南京市/ns,职业学校/nt
「招生」栖霞区西岗幼儿园2018年秋季招生预告	栖霞区/ns
祝贺这些孩子们！济宁市有14人（次）通过清华北大自主招生初审	济宁市/ns
「直通校园」晋源区第三实验小学开展防灾减灾日教育活动	晋源区/ns,晋源区/ns,第三实验小学/nt,第三实验小学/nt
「直通校园」太原市第四实验小学校进行消防安全演练	太原市/ns,第四实验小学校/nt
「重磅」2018年山东专升本录取结果5月21日公布！	山东/ns
「重磅消息」衡水要求民办学校必须独立办学并严禁超规模招生！	衡水/ns
「重磅消息」武汉医学预科班招生计划，具体流程详解！	武汉/ns
「最新」2018年滨海新区初中招生学片划分公布	滨海新区/ns
100人选2！比河西开盘还震撼！今天，南京数万家长冒雨“赶考”	南京/ns,河西/ns
100人选2！比河西开盘还震撼！今天，南京数万家长冒雨“赶考”！	南京/ns,河西/ns
10所知名民族大学，西藏民族大学竟坐落于咸阳，有你在读的学校？	西藏/ns,咸阳/ns
10中国顶尖独立学院二本考生不错的选择	中国/ns,独立学院/nt
12日教育热点：1988-2018，116所小学从南京消失了	南京/ns,小学/nt
株洲考生注意！倒计时一个月 今年高考有这些新变化	株洲/ns
18年山东高考生580分能上211大学吗？	山东/ns,211大学/nt
1988-2018，116所小学从南京消失了	南京/ns,小学/nt
重要｜西充考生、家长们，这些考生可在四川高考录取中加分！	四川/ns
重要！湛江考生和家长：广东高考可填“不服从调剂”专业志愿了	广东/ns,湛江/ns
重庆一学校班主任收了学生学费后跑路了 学校：以后会加强管理	重庆/ns
重庆一小学体育老师罚学生赤脚跑操场磨出泡，当地教委介入	重庆/ns
重庆一小学体育老师罚学生赤脚跑操场脚底磨出泡 当地教委介入	重庆/ns
重庆一小学体育老师罚学生赤脚跑操场脚底磨出泡	重庆/ns
2017广东各大高校排名？	广东/ns
重庆小学老师罚学生赤脚跑操场：有孩子脚底磨出泡	重庆/ns
重庆文科生二模470分左右，可以报哪些重庆地区的学校？	重庆地区/ns,重庆/ns
重庆潼南一小学体育老师罚二年级学生 赤脚跑操场脚底磨出泡	重庆/ns,潼南一小学/nt
重庆潼南朝阳小学一体育老师罚学生赤脚跑操场 当地教委介入处理	重庆/ns
重庆某学校 请假还要贴家长身份证正面照	重庆/ns
重庆理科考生模拟考比重本线多60分，想读临床医学，能报哪些大学？	重庆/ns
2017年河南考生480分能上什么样二本医学院？	河南/ns,医学院/nt
重庆今年高考照顾政策出炉 符合下列条件可加5分或10分投档	重庆/ns
2017年四川高考各高校各专业一本，二本录取分数是多少？	四川/ns
重庆回应体育老师体罚学生赤脚跑步：将按规定作出相应处理	重庆/ns
重庆对四川的招生情况怎么样？	四川/ns,重庆/ns
2017重庆各大高校排名？	重庆/ns
重庆2018高考政策来了！符合这些条件可加5分或10分！	重庆/ns
重庆 符合这些条件 高考可加5分或10分	重庆/ns
2018北京朝阳区高三二模英语学科剖析+北京高考预测	朝阳区/ns,北京/ns
重磅丨清华大学2018年自主招生初审名单公布 陕西省36人入榜单！	陕西省/ns
重磅丨北京大学2018自主招生初审名单公布 陕西67人通过（附名单）	陕西/ns
重磅｜2018天津普通高等学校招生工作、志愿填报、录取等规定发布	天津/ns,普通高等学校/nt
重磅！四川省2018年高考方案公布，全面取消特长生等加分项目	四川省/ns
重磅！四川省2018年高考方案出炉	四川省/ns
重磅！四川2018年普通高校招生实施规定出台	四川/ns
重磅！清华北大今年自主招生名单公布，珠海4人上线	珠海/ns
重磅！宁夏调整和规范高考加分项目及分值！	宁夏/ns
重磅！2018学年中山市义务教育阶段直属中小学招生方案公布	中山市/ns
重磅！2018年天津市普通高等学校招生工作规定公布	天津市/ns,普通高等学校/nt
重磅！2018年秋季学期九江部分小学实行弹性上学试点	九江/ns,部分小学/nt
重磅！2018广州各区多所名校举办小升初开放日，家长别错过！	广州/ns
2018高考：英国本科名校申请，对高考“独木桥”说NO	英国/ns
钟山区大湾镇组织木冲沟中学开展禁毒文艺演出及校园周边禁毒宣传活动	钟山区/ns,木冲沟中学/nt
中职学生有机会“直通”本科，利好政策再袭浙江学生	浙江/ns
中职学生可以“直通”本科！浙江试点开展中职与应用型本科一体化人才培养	浙江/ns
2018广东高考和6月份高中学考科目时间安排出炉！	广东/ns
2018广东高考考什么？如何考？	广东/ns
2018广东省考笔试成绩查询入口｜时间	广东省/ns
2018河北理科考生二模578.5能报考什么大学？	河北/ns
中山市直属小学一年级招生电脑派位6月20日举行	中山市/ns,直属小学/nt
中山18名学霸通过清华北大自主招生初审！哪所高中最受青睐？	中山/ns
中山1.7万余学子报名参加今年高考	中山/ns
2018年北京高考，这8种情况下的学生可以加分照顾或优先录取！	北京/ns
2018年春季音乐类各层次考生招生计划—衢州衍声高考琴行	衢州/ns
2018年东北师范大学在山东的招生情况如何？	山东/ns,东北师范大学/nt
2018年度中山积分入学等指标公布，家长快看	中山/ns
2018年高考倒计时30天！江苏高考权威信息都在这里！	江苏/ns
2018年高考后，还有哪些英国预科课程来得及申请？	英国/ns
2018年高考考生请注意！广西高考志愿填报演练今天开始！	广西/ns
2018年高考陕西文科550能上哪些师范院校？	陕西/ns
2018年广东高考不好好努力，上大学形势非常严峻	广东/ns
2018年广东高考深圳大学录取预计排位是多少？	广东/ns
2018年广东高考文科520分能上什么大学？	广东/ns
2018年广东文科生二模490左右，能报广东哪些学校？	广东/ns
2018年海门市“心理阳光工程”未成年人心理健康教育、家庭教育百校行活动正式启动	海门市/ns
2018年海门市“心理阳光工程”未成年人心理健康教育、家庭教育百校行启动仪式在平山小学举行	海门市/ns,百校行/nt,平山小学/nt
2018年河南高考考生有多少？	河南/ns
2018年湖北文科考生，560分可以上什么大学？有什么推荐的专业？	湖北/ns
2018年湖南理科440分能报哪些二本学校？	湖南/ns,二本学校/nt
2018年湖南文科3000名能上什么大学？	湖南/ns
2018年南京中考加分今起申请！申报贴士看这里	南京/ns
2018年清华、北大自主招生初审名单公布，北京最多	北京/ns
2018年清华北大公布保送生拟录名单 湖南34名学生在列	湖南/ns
2018年山东春季高考开考，招生录取时间表出炉	山东/ns
2018年山东省高考人数	山东省/ns
2018年山东一模理科535分，报什么大学好？	山东/ns
2018年陕西26.8万人高考！附近11年在陕高考人数变化及影响	陕西/ns
2018年陕西高考报考总人数超31万	陕西/ns
2018年陕西高考总人数26.8万人！分析陕西高考人数变化及其影响！	陕西/ns
2018年陕西高校综合实力排名是怎样的？	陕西/ns
2018年上海高考时间表出炉 将于6月7日-9日举行	上海/ns
2018年上海高考时间公布｜为6月7、8、9日！	上海/ns
2018年上海高考时间和安排确定	上海/ns
2018年上海高考时间和安排确定！	上海/ns
2018年深圳市中考英语听说考试流程安排、注意事项及答题技巧	深圳市/ns
2018年四川高考：全面取消特长生等加分项目	四川/ns
2018年四川高考及招生录取工作时间安排表	四川/ns
2018年四川高考新规出台 专家提醒：“体检”要求不容忽视！	四川/ns
2018年四川高三理科学生，平时能考560分左右，能上一本的大学吗？	四川/ns
2018年四川高三文科三模528分，省内能上哪些学校？	四川/ns
2018年四川理科考生500分左右能报哪些学校？	四川/ns
2018年四川理科考生570分能上哪些学校？	四川/ns
2018年泰安市各县市区高中招生计划表	泰安市/ns,高中/nt
2018年潍坊市普通高考共报名72534人	潍坊市/ns
2018年西安城区30所民办初中最新收费标准、“摇号”地点公布！	西安/ns,民办初中/nt
2018年西藏第一批考录笔试成绩可以查询啦！仅1165名考生合格！	西藏/ns
2018年漳州市民办学校初一年级招生工作意见出台	漳州市/ns
2018年长沙中考指标生计划分配表，附填报注意事项	长沙/ns
2018年浙江高考志愿填报指南	浙江/ns
2018年重庆普通高考招生信息整理	重庆/ns
2018清北自主招生500强高中排行榜发布，四川有这些中学上榜！	四川/ns
2018清华大学在河南省的招生是多少？	河南省/ns
2018山东高考招生咨询会拉开帷幕 助力考生成功选择大学	山东/ns
2018山东理科560分能上什么大学？	山东/ns
2018山东文科二模成绩在517分左右，能上什么大学？	山东/ns
2018山东夏季高考时间和科目这么安排！4类考生可加分	山东/ns
2018山东夏季高考时间科目安排情况！来看看你家娃能不能加分？	山东/ns
2018山东夏季高考时间科目这么安排 4类考生可加分	山东/ns
2018山西理科470分可以报哪些大学的计算机专业？	山西/ns
2018四川高考报考武汉大学如何了解各专业录取分线？	四川/ns
2018四川高考录取照顾政策出台，符合这些条件将优先录取！	四川/ns
2018四川高考实施规定出台 考试时间科目不变 使用全国卷	四川/ns
2018四川普通高校招生工作规定出台，今年6月7、8日高考！	四川/ns
2018四川文科一模考试600分能上哪些大学？	四川/ns
2018新高考元年，浙沪顶级专家齐聚武汉开展新高考3+3公益讲座	武汉/ns
2018学年中山市义务教育阶段 直属中小学招生方案公布	中山市/ns
2018浙江高考规定出台 共计30.6万考生报名	浙江/ns
郑州小升初｜这些特色班实验班家长必看！	郑州/ns
2018中国最好大学排名，天津高校排名如何？	中国/ns,天津/ns
珍爱生命 预防溺水 雅安外实小开展安全教育活动	雅安/ns
珍爱生命 谨防溺水——淅川县寺湾镇大坪小学防溺水活动阶段总结	淅川县/ns,寺湾镇/ns
浙江新高考闹乌龙，十年寒窗高分却只能上三本，责任究竟在谁？	浙江/ns
浙江新高考录取最火专业竟然是口腔医学，为什么这么多人想学牙医？	浙江/ns
浙江省的985、211大学只有浙大，是否可以说浙江省的大学教育质量差？	浙江省/ns,大学/nt
浙江今年高考人数首破30万人	浙江/ns
245分文科能上什么学校？山西？	山西/ns
485分山东文科能上什么学校？	山东/ns
这很可怕！中国老师开始害怕学生了……	中国/ns
安徽72名高考生获北大、清华录取“优惠券”	安徽/ns
安徽72名高考生通过清华、北大自主招生审核！太牛，最高可降60分录取！	安徽/ns
安徽理科生每年高考前多少名可以达二本线？	安徽/ns
安徽理科生三模考了500分高考有机会考上一本吗？	安徽/ns
安徽毛坦厂中学吸引学生就读的“两大法宝”	安徽/ns,毛坦厂中学/nt
蚌埠家长呼吁：历史开卷，取消月考，市教育局作出回应	蚌埠/ns
保送生拟录取名单公布，这些孩子将不再参加河南高考！	河南/ns
北大清华公布今年自主招生初审名单 重庆138人通过	重庆/ns
北大清华公布今年自主招生初审名单 重庆138人通过赶超四川	四川/ns,重庆/ns
北大清华公布自主招生初审名单 绍兴30名学生上榜	绍兴/ns
北大清华公示自主招生初审名单 湖北近百人通过初审资格	湖北/ns
北大清华自主招生初审湖北学生表现亮眼，华师一36人过关位列前十	湖北/ns
北大清华自主招生初审名单出炉 来看看宁波有多少学子上榜	宁波/ns
北大清华自主招生初审名单公布 东营29人上榜	东营/ns
北海家长注意！海城区小学开始招生啦！与往年不同	北海/ns,海城区/ns
北京：高中合格性考试8日起网上报名	北京/ns
北京“新高考”首次合格性考试报考系统今天开放	北京/ns
北京“新高考”首次合格性考试今起报考	北京/ns
北京“新高考”首次合格性考试今起报考 开考八个学科	北京/ns
北京本地人心中对北京各高校大学的排名？	北京/ns,北京各高校大学/nt
北京大学公布自主招生初审名单 湖南122名考生入选	湖南/ns
北京家长留意！9所高中发布2018招生计划，附2017分数线&报考条件	北京/ns
北京家长注意！这几个区本周开始办理回户籍所在地小升初	北京/ns
云择校数据解析沈阳农业大学录取数据	沈阳/ns,农业大学/nt
云择校数据解析沈阳建筑大学录取数据	沈阳/ns
预约抢座！广东名校招生办教你填志愿，3万惠州高考生仅120个名额	广东/ns,惠州/ns
预防小学生沉迷手机，江津这个小学有妙招	江津/ns
预防溺水从我做起！遂平县三中开展安全教育系列活动	遂平县/ns
预测甘肃高考录取分数线？	甘肃/ns
滨州中小学2018年暑假时间确定 家长们准备接招吧	滨州/ns
滨州中小学2018年暑假时间确定！家长们准备接招吧！	滨州/ns
榆社县中小学幼儿园预防校园欺凌现场会在职业中学召开	榆社县/ns,中小学幼儿园/nt
榆次大学城有多少所本科学校？	榆次/ns
渝北区招生方案公布 八中渝北校区招生范围划定	渝北区/ns
幼升小丨东城区小学排名与重点小学划片范围（附划片查询地址）	东城区/ns,重点小学/nt
又是一年高考时 今年广西高考考生将首破40万人 再创历史新高	广西/ns
永安三中高中部紧抓管理不放松 严把校园安全秩序关	永安/ns
宜昌考生注意！高考倒计时，这些新变化你必须知道！	宜昌/ns
宜昌90后女教师高考前带伤讲课	宜昌/ns
宜宾考生注意！倒计时一个月 今年高考有这些新变化→	宜宾/ns
依法治考 海南部署2018普通高校招生考试安全工作	海南/ns
一切为了孩子安全-延津县检察院联合开展青少年防震演练和法治教育活动	延津县/ns
滁州学院信息学院2018考研录取人数再创新高	滁州/ns,学院信息学院/nt
春季高考5月12日至13日举行 我市在广饶一中设考点	广饶/ns
春季高考本周六开考 济宁5665人参加笔试 数学等科目可带函数型计算器	济宁/ns
大家怎么看南昌女孩被“全球最难考”大学录取，奖学金200万，却称还没想好去不去？	南昌/ns
大数据｜全国教育经费投入更多！中国人更加重视教育！	中国/ns
学校举债学生捐款英山一中捐款事件最新：所收资金已退还	英山/ns
德阳两所学校获评“国家防震减灾科普示范学校”	德阳/ns
德阳市华山路学校举行防震减灾应急疏散演练	德阳市/ns,华山路学校/nt
德阳市两所学校获评“国家防震减灾科普示范学校”	德阳市/ns
定边县第二中学召开安全警示教育大会	定边县/ns,第二中学/nt
定了！2018广东高考加分和优先录取政策，与你息息相关	广东/ns
定了！2018年江苏高考的那些事儿，看这里……	江苏/ns
定了！2018年四川省高考实施规定出台，考试时间和科目不变	四川省/ns
定了！2018山东夏季高考时间和科目这么安排	山东/ns
定了！今年上海高考时间6月7、8、9日！	上海/ns
定了！深圳自主招生6月1日—4日报名，7月1日面试+人机对话！	深圳/ns
定了！深圳自主招生6月1日—4日报名，新增二外自招！	深圳/ns
东莞部分儿童小升初要做亲子鉴定？教育办：造假太多	东莞/ns
东莞的公办学校好还是私立学校好 积分入学不够怎么办	东莞/ns,公办学校/nt
东莞虎门太平小学要求入读公办小学需要提供亲子鉴定证明	东莞/ns,虎门太平小学/nt,公办小学/nt
东莞家长，孩子积分入学，社保分数能用微信直接查询了	东莞/ns
东莞入读公办学校需做亲子鉴定，你怎么看？	东莞/ns,公办学校/nt
东莞一孩子想读公办学校，被要求做亲子鉴定	东莞/ns,公办学校/nt
形势严峻！千万高考大军在奋战，留学澳洲的五种选择重磅出炉！	澳洲/ns
东坡区崇礼小学增强师生防震减灾意识 提高逃生自救能力	东坡区/ns,崇礼小学/nt
东坡区柳圣小学开展防震减灾应急疏散演练活动	东坡区/ns,柳圣小学/nt
东营考生 今年10所高校在我省开展综合评价招生试点	东营/ns
新高考改革，浙江高考选物理考生不到3成，且“弃物理”趋势一直蔓延，你怎么看？	浙江/ns
二本大学文科分比较低的大学有哪些（最好是四川）？	四川/ns,二本大学/nt
二诊成绩是478.5，能报重庆的哪些学校？	重庆/ns
发现沈阳一线教师在外面补课，应该怎么举报？	沈阳/ns
防溺水工作 常抓不懈 警钟长鸣 淅川县滔河乡黄龙庙小学	淅川县/ns,滔河乡黄龙庙小学/nt
防灾减灾主题活动走进成都一所幼儿园，孩子们以游戏的形式学习安全防范知识，你怎么看这样的形式？	成都/ns,成都/ns
福建2018年高考报名人数达20万余人 今年可加分项目有哪些	福建/ns
福建20万考生6月迎战高考 今年福建取消两类加分	福建/ns
福建20万考生下月迎战高考 今年福建取消两类加分	福建/ns
福建20万考生迎战2018年高考 高考加分政策有变化	福建/ns
福建56名考生通过清华北大自招初审 清华27名北大29名	福建/ns
福建56名学霸通过清华北大2018自主招生初审！这些中学名列前茅！	福建/ns
福建省2018年普通高考外语口试本月14日开始报名	福建省/ns
淅川县寺湾镇中心学校：开展学生夏季“防溺水”安全教育	淅川县/ns,寺湾镇中心学校/nt
淅川县金河镇中心学校举行防溺水安全知识竞赛	淅川县/ns
西平产业集聚区中心校积极开展防溺水安全教育	西平/ns,产业集聚区中心校/nt
西安一学院教官调戏女生，真实情况竟然……	西安/ns
西安新落户人口子女小学升学、中高考就学办法！不符须回户籍地	西安/ns
西安新落户人口子女就学办法发布：今年高考回原户籍地！	西安/ns
无锡严查严管在职教师有偿补课 违规者面临严厉处罚	无锡/ns
为学生减压 南昌发布“十不准” 对校外培训说不	南昌/ns
为泰安考生加油！高考倒计时一个月！今年有这些新变化！	泰安/ns
为什么称位于六安的毛坦厂中学是“亚洲最大高考工厂”？	亚洲/ns,六安/ns,毛坦厂中学/nt
网曝英山一中要求高三学生捐款	英山/ns
铜仁市开展校园安全联合大检查	铜仁市/ns
天河区教育局公布义务教育阶段学校招生政策，44中并入113中	天河区/ns
泰州公办、民办幼儿园收费标准发生重大变化！	泰州/ns
泰安师范附属学校召开“架起心灵沟通的桥梁”—心理健康教育主题中队会	泰安/ns,师范附属学校/nt
泰安今年约有3.5万名考生参加夏季高考	泰安/ns
泰安11名学生上榜北大清华自主招生初审名单	泰安/ns
泰安：多措并举打造平安高考	泰安/ns
泰安：“按需助学”缓解了有偿补课依赖	泰安/ns
太原市晋源区北瓦窑小学开展防震减灾应急疏散演练活动	晋源区/ns,太原市/ns
遂平第三小学开展防溺水安全知识教育宣传活动	遂平/ns,第三小学/nt
速看2018年上海、天津、广东、福建、贵州，这5个省市高考新消息	天津/ns,上海/ns,福建/ns,广东/ns,贵州/ns
泗县墩集镇三村小学召开防溺水教育动员会	泗县/ns,墩集镇三村小学/nt
四川文科考生580分左右，2018年能报哪些学校呢？	四川/ns
四川文科高考596分可报哪些学校？	四川/ns
四川省2018年高考实施规定出台，这些方面需注意！	四川省/ns
四川省2018年高考实施规定出台，本一本二设6个平行第一志愿	四川省/ns
四川省2018年高考方案公布：全面取消特长生等加分项目	四川省/ns
四川省2018年高考方案公布 全面取消特长生等加分项目	四川省/ns
四川省2018年6月参加高考的人数有多少，全省排名至少多少能进入985、211？	四川省/ns
四川理科635分能上什么学校？	四川/ns
四川理科580分可以上什么学校？	四川/ns
四川考生女孩理科，一模成绩500左右，想报图书馆理，语言类专业，可以报哪些学校？	四川/ns
四川高考招生规定新鲜出炉，艺体类填报志愿6月28日17点以前完成	四川/ns
四川高考考试前的那点事！你遇见过了吗？	四川/ns
四川大学华西医科在上海的录取分数线是多少？	华西/ns,上海/ns
四川成都文科555分能读哪些学校？	四川/ns,成都/ns
四川45个深度贫困县高考设“深贫专项计划”，志愿填报单设批次、单独录取	四川/ns
四川2018年普通高校招生实施规定出台	四川/ns
四川2018年高考实施规定出台 考生注意！高考须注意这些问题	四川/ns
四川2018年高考实施规定出台	四川/ns
四川2018年高考方案公布 取消特长生等加分项目	四川/ns
四川2018年高考方案，全面取消体育特长生、奥赛、等加分项目！	四川/ns
四川2018年高考：本一本二可报6个平行第一志愿	四川/ns
四川2018高考招生方案公布：使用全国卷 高考时间安排	四川/ns
四川：龙马潭区玉带河学校开展毕业班学生心理健康辅导活动	四川/ns,龙马潭区/ns
睡前必看的几则西安教育资讯	西安/ns
睡前必看的几则温州教育资讯	温州/ns
睡前必看的几则南京教育资讯	南京/ns
睡前必看的几则广州教育资讯	广州/ns
书包太重对孩子有啥影响？杭州一小学体育老师做了个研究	杭州/ns
嵊州：全国普通高校招生考试安全工作暨 全省普通高校招生考试工作电视电话会议召开	嵊州/ns
省情｜今年陕西省31.9万学子冲刺高考	陕西省/ns
省教院专业解读｜四川省2018年高考志愿这样填！	四川省/ns
省教育厅发布一则通知！关系到蚌埠所有的家长和孩子！	蚌埠/ns
升学早知道！济南小升初招生信息汇总！	济南/ns
深圳自主招生官方政策出炉！	深圳/ns
深圳自主招生6月1日报名，新增一所学校（附2017年自招面试题）	深圳/ns
深圳中考近三年，深圳各高中录取分数线汇总！给自己有个底	深圳/ns
深圳6所公办普高自主招生计划定了	深圳/ns
深圳6所公办普高开展自主招生改革试点	深圳/ns
邵阳县8000余名九年级学生陆续参加2018年体育中考	邵阳县/ns
陕西今年高考报名人数31.9万 确保招生公平公正	陕西/ns
陕西今年高考报名人数31.9万 坚守招生公平公正	陕西/ns
陕西今年31.9万学子冲刺高考 与去年基本持平	陕西/ns
陕西19名学生被刺杀｜无论有多大委屈，请放过孩子！	陕西/ns
山西省长治市有哪些高校？	山西省/ns,长治市/ns
山西省忻州市有哪些高校？	山西省/ns,忻州市/ns
山西省吕梁市有哪些高校？	山西省/ns,吕梁市/ns
山西省临汾市有哪些高校？	山西省/ns,临汾市/ns
山西省晋中市有哪些高校？	山西省/ns,晋中市/ns
山西理科一模460分。能考什么大学？	山西/ns
山西理科462能上什么大学？	山西/ns
山西考生超一本130分，能上什么大学？	山西/ns
山东省高考生2018理科450分左右，在山东能上什么学校？	山东/ns,山东省/ns
山东省高考改革怎么选科好？	山东省/ns
山东省春季高考今日开考 考试期间家长注意事项	山东省/ns
山东省59.2万人参加高考，全国第三	山东省/ns
山东省2018年59.2万人参加高考 考生数居全国第3	山东省/ns
山东省2018高考安全工作电视会议召开	山东省/ns
山东理科生一模成绩420分能报什么样的大学？	山东/ns
山东理科生多少分能考上长安大学？	山东/ns
山东理科二模602分能报考什么大学？	山东/ns
山东考生考了590分左右，可以报考哪些学校？	山东/ns
山东考生刚过一本线，想学语言能上什么大学？	山东/ns
山东今年高考人数达59.2万 较去年增加了近万人	山东/ns
山东今年59.2万人参加高考，考生人数居全国第三	山东/ns
山东户籍，高考550分，能上哪些大学？	山东/ns
山东高考500分，能上哪些大学？	山东/ns
山东春季高考有哪些信息你必须知道？一起来看看	山东/ns
山东9所高校招生简章陆续公布 青大对获奖有要求	山东/ns
山东7所高校发布高考综合评价招生简章，千万别错过！	山东/ns
山东75419名考生参加2018年春季高考知识考试	山东/ns
山东2018综招政策发布 10所高校成绩评定方式、录取原则全解读	山东/ns
山东2018年春季高考开考 招生录取时间表出炉	山东/ns
山东2018年59.2万人参加高考 考生数居全国第3	山东/ns
山东10所高校试点综招 九所驻鲁院校计划公布	山东/ns,九所/ns
山东10所高校试点综合评价招生 9所院校计划公布	山东/ns
厦门民办小学女教师戒尺体罚女生，学校：已和解，教师被辞退	厦门/ns
厦门民办小学教师打肿女生后背 学校：已辞退 双方和解	厦门/ns
厦门教师戒尺体罚：学校称和解为何还要辞退教师	厦门/ns
考试不认真，作文不及格 通城一老师体罚学生引家长不满	通城/ns
泰山二日游	泰山/ns
都江堰景区	都江堰/ns
三亚一日游	三亚/ns
华山景区通告	华山/ns
沙家浜风景区	沙家浜/ns
张掖青海三日游	张掖/ns,青海/ns
内蒙古网红景区	内蒙古/ns
长汀沿线自驾游	长汀/ns
青岛北九水风景区	青岛/ns
鞍山有哪些景区？	鞍山/ns
母亲节九寨沟一日游	九寨沟/ns
黄山三日游多少钱？	黄山/ns
山东潍坊沂山风景区	山东/ns,潍坊/ns
河北有哪些5A景区？	河北/ns
福建有哪些5A景区？	福建/ns
自驾游去西安怎么样？	西安/ns
忻城县薰衣草庄园景区	忻城县/ns
南京幕府滨江风光景区	南京/ns
沈阳一日游怎么安排？	沈阳/ns
重庆十大必去旅游景区	重庆/ns
实拍：缅甸另类的景区	缅甸/ns
绵阳新增三家4A级景区	绵阳/ns
奇骏自驾游去西藏如何？	西藏/ns
邯郸旅游圣地旅游风景区	邯郸/ns
5月关西7日游，精华图	关西/ns
自驾游西藏要准备什么？	西藏/ns
山西太原汾河二库一日游	汾河/ns,山西太原/ns
长春周边一日游哪里好？	长春/ns
自驾游｜敦煌必去的景点	敦煌/ns
广州有哪些A级风景区？	广州/ns
宁夏水洞沟旅游景区游记	宁夏/ns
南阳有什么免费的景区？	南阳/ns
青州5A级景区值得你来	青州/ns
山西六日游该怎么游玩？	山西/ns
走进湖北千年古树群风景区	湖北/ns
哪些车更适合西藏自驾游？	西藏/ns
航拍重庆永新梨花山风景区	重庆/ns
横店影视城秦王宫一日游攻略	横店/ns
重庆一日游，怎么安排行程？	重庆/ns
长沙有哪些免费的旅游景区？	长沙/ns
“南浦溪”原始特色的风景区	南浦/ns
从西安到宁夏自驾游怎么走？	宁夏/ns,西安/ns
三亚八日游，带你一起去看海	三亚/ns
因强降雨新县多景区临时关闭	新县/ns,新县/ns
有北京到青海自驾游路书吗？	北京/ns,青海/ns
黑龙江自驾游线路精选《四》	黑龙江/ns
平顶山有哪些人文古迹景区？	平顶山/ns
华山门票降价 景区客流平稳	华山/ns
天山天池慵懒休闲品质一日游	天山/ns,天池/ns
去四川旅游，这个景区不能少	四川/ns
太原到上海自驾游如何规划？	太原/ns,上海/ns
安徽水墨汀溪风景区怎么样？	安徽/ns
南京两日游，行程该怎么安排？	南京/ns
武汉到贵阳自驾游如何安排好？	武汉/ns,贵阳/ns
北戴河：加大景区提升改造力度	北戴河/ns
重庆有几个AAAAA级景区？	重庆/ns
北京半日游独家推荐「颐和园」	北京/ns,颐和园/ns
这才是安阳附近最好的一日游！	安阳/ns
云南最美的十大风景区是哪些？	云南/ns
一日游的好去处-广州增江画廊	广州/ns
大槐树景区：被忽略的另一种美	大槐树/ns
韶关周边三日游如何规划路线？	韶关/ns
去新疆自驾游开什么车最省心？	新疆/ns
四川泸州有哪些景区比较好玩？	四川/ns,泸州/ns
辽宁5A景区推出“超级联票”	辽宁/ns
宁波象山三日游如何规划路线？	象山/ns,宁波/ns
罗山灵山寺 国家4A级风景区	罗山/ns
这一天，滁州这些景区送福利啦！	滁州/ns
求两个人，天津两日游旅游攻略？	天津/ns
周末休闲好去处，大舟山风景区！	舟山/ns
福建居民游宁夏 23景区免门票	宁夏/ns,福建/ns
洛阳白云山景区：观日出温馨提示	洛阳/ns
超超超详细「珠海」两日游攻略！	珠海/ns
杭州西湖两日游，怎样制定行程？	杭州/ns,西湖/ns
乐山人去峨眉山景区门票多少钱？	乐山/ns,峨眉山/ns
铜陵地区有哪些地方适合自驾游？	铜陵/ns
鞍山市千山景区十一假期挤不挤？	千山/ns,鞍山市/ns
芮城圣天湖景区都有什么好玩的？	芮城/ns
武安七步沟景区喜迎首批旅居老人	武安/ns
长春周边有哪些自驾游的好去处？	长春/ns
三门峡天鹅湖景区收门票合理吗？	天鹅湖/ns,三门峡/ns
安徽滁州有哪些不错的旅游景区？	滁州/ns,安徽/ns
三亚 海南海滨美食，美景六日游	三亚/ns,海南/ns
太原到青海湖自驾游有去过的没？	太原/ns,青海湖/ns
关于降低华山景区门票价格的公告	华山/ns
北京到厦门自驾游，如何规划线路？	北京/ns,厦门/ns
茅山景区南镇街入选省传统村落名录	南镇/ns,茅山/ns
湛江最美十大旅游景区，来湛江必去	湛江/ns
新乡一日游亲子游最好玩的在哪里？	新乡/ns
西安樱桃谷一日游，推荐+价格指导	西安/ns
白城市有哪些值得一去的旅游景区？	白城市/ns
从哈尔滨到西藏自驾游得花多少钱？	西藏/ns,哈尔滨/ns
广东多个景区 中国旅游日将推优惠	中国/ns,广东/ns
郑州周边有哪些适合一日游的景点？	郑州/ns
5月起，成都一大拨景区限时免费耍	成都/ns
5月起 成都一大拨景区限时免费耍	成都/ns
华山景区5月10日起降低门票价格	华山/ns
南岳衡山景区惊现“双彩虹”等奇观	衡山/ns
母亲节来临 南湾湖景区女性半价优惠	湖景区/ns,南湾/ns
山西最具影响力十大景区，你去过几个	山西/ns
汶河景区内的泉林社区什么时候开工？	汶河/ns
自驾游西藏无人区加油问题怎么解决？	西藏/ns
随州大洪山风景区开启项目建设年模式	随州/ns
观赏青海湖最佳的地点二郎剑景区攻略	青海湖/ns
一个南宁人的北海2日自助自驾游方案	北海/ns
不一样的崂山景区，游前必须要知道的	崂山/ns
广州出发到杭州自驾游，有哪些路线？	广州/ns,杭州/ns
新疆新源县萨哈景区云雾缭绕宛如仙境	新疆/ns,新源县/ns
桂西桂北景区防降雨 桂南沿海宜出游	桂北/ns,桂南/ns,桂西/ns
四川巴中光雾山大坝景区风光随拍欣赏	四川/ns,巴中/ns
仙峪景区：躺在华山脚下的“维纳斯”	华山/ns
新疆鹿角湾风景区你值得去的避暑圣地	新疆/ns
重庆一景区观光小火车从居民楼中穿过	重庆/ns
池州市将启动旅游景区免费开放周活动	池州市/ns
5.19兖州兴隆文化园景区免费了！	兖州/ns
去广西旅游，自驾游应该去哪些地方？	广西/ns
河南面积最大镇，4A、5A景区都有	河南/ns
2018自驾新疆 印象喀纳斯8日游	新疆/ns
在三亚吃海鲜便宜，市场“宰客套路”深	三亚/ns
凤凰山景区耗巨资打造UFO主题公园！	凤凰山/ns
梦幻喀纳斯湖，禾木乡 汽车经典四日游	喀纳斯湖/ns
山西这个自驾游胜地，争着抢着都要去！	山西/ns
从贵州凯里到云南自驾游，该如何规划？	贵州/ns,云南/ns
豫剧《重渡沟》在重渡沟风景区精彩上演	重渡沟/ns
玉泉区：强化旅游景区周边道路交通秩序	玉泉区/ns
又来一波！安徽这些景区，门票有优惠！	安徽/ns
新疆新源县萨哈景区云雾缭绕 宛如仙境	新疆/ns,新源县/ns
响应国家号召，陕西华山景区率先降价！	陕西/ns,华山/ns
河南13个5A景区介绍，你去过几个？	河南/ns
「重磅」柳州又添三家国家4A级景区！	柳州/ns
5.19中国旅游日石膏山风景区免门票	中国/ns
最后4天！沩山密印景区将恢复门票收费	沩山/ns
澳洲有哪些沿途风景优美的自驾游路线？	澳洲/ns
北戴河自驾游，住酒店还是农家院合适？	北戴河/ns
实力上榜，尧山荣登中国最具影响力景区	中国/ns
重庆周边有哪些适合周末自驾游的地方？	重庆/ns
衢州开化“全域景区化” 升级美丽乡村	衢州/ns
中国第一情峡红豆峡、八泉峡自驾两日游	中国/ns,八泉峡/ns
浙江16个5A景区介绍，你去过几个？	浙江/ns
浙东大峡谷现代游乐为特色的生态风景区	浙东/ns
城事｜防城港A级景区，存起来，去走走	防城港/ns
出征！“大美西藏”自驾游之旅正式启程	西藏/ns
从广东到西藏自驾游一趟需要多少预算？	西藏/ns,广东/ns
来到湖南不得不去的景区——君山风景区	湖南/ns,君山/ns
洛阳民俗游的代表性景区——伊滨区倒盏村	洛阳/ns
专家组对临沂罗庄区A级景区进行检查复核	临沂/ns,罗庄区/ns
河南周边自驾游，有哪些好玩的地方推荐？	河南/ns
浦江县七里方宅小学播报︱我为景区设标语	浦江县/ns,七里方宅小学/nt
天山天池、国际大巴扎 纯玩无购物一日游	天山/ns,天池/ns
佛山推出放心消费旅游景区，有哪些景区？	佛山/ns
从天津去新疆自驾游，二十天时间够用吗？	新疆/ns,天津/ns
大C游世界 松下G9行摄川西海螺沟景区	川西/ns
四川的12个5A景区介绍，你去过几个？	四川/ns
丽江一日游，给自己一次说走就走的小旅行	丽江/ns
网红重庆一日游：忘不了的两个“味道”！	重庆/ns
广西贵港到贵州，7日自驾游该怎么规划？	广西/ns,贵州/ns,贵港/ns
极力推荐的深圳周末一日游的景点路线攻略	深圳/ns
新疆自由行自驾游攻略，必去的十个地方！	新疆/ns
滁州的琅琊山风景区怎么样？值得一去吗？	滁州/ns
赤峰周边一日游的爆款景点，你去过几个？	赤峰/ns
桂西桂南景区仍有降雨 出行游玩注意安全	桂南/ns,桂西/ns
海淀美术馆北馆开馆 位于海淀稻香湖景区	海淀/ns,美术馆北馆/nt
观花海 摘鲜果 东阳出现一个“网红”景区	东阳/ns
换新颜！郑州这条“臭水沟”要变5A级景区	郑州/ns
安捷包装2018年南京一日游活动圆满结束	南京/ns
点赞！绵阳新增三家4A级景区，分别是……	绵阳/ns
初夏，同州湖景区内月季花盛开啦！（组图）	同州/ns
江西抢游客放大招 5A景区对境外游客免票	江西/ns
贵阳到北海自驾游沿途景点有什么值得推荐？	北海/ns,贵阳/ns
今天起，河南这些景区免门票！快来看看吧！	河南/ns
天津有哪些5A级旅游景区？哪些比较好玩？	天津/ns
成都出发到深圳自驾游，沿途怎么合理安排？	成都/ns,深圳/ns
天池景区迎来雨雪天气 游客天山深处赏雪景	天山/ns,天池/ns
正宁县中华黄帝文化旅游景区项目正在建设中	正宁县/ns
游上饶｜净心洗肺之旅（铅山葛仙山风景区）	铅山/ns,上饶/ns
柳江古镇：4A级景区，在这里寻找最慢时光	柳江/ns
「老家见闻」大槐树景区：被忽略的另一种美	大槐树/ns
《极速风云2》外景拍摄基地——天峡风景区	天峡/ns
西海博斯腾湖罗布人村寨、库尔勒汽车三日游	西海/ns
潜山县2018年景区讲解员岗前培训班开班	潜山县/ns
免费！5月19日青海省坎布拉景区免门票！	青海省/ns
四川景区扮寺庙，假和尚骗游客出钱“做功德”	四川/ns
壶口瀑布景区到底属于陕西，还是属于山西呢？	陕西/ns,山西/ns
出门游玩啦！阜阳5月19日多个景区门票半价	阜阳/ns
倒计时12天，阜阳这些景区将集体全部半价！	阜阳/ns
广东省河源市AAAA级景区——镜花缘风景区	河源市/ns,广东省/ns
漫步渭南华州少华山景区，来一场诗意的邂逅！	渭南/ns,华山/ns
这天成都租车自驾游川西四姑娘山景区半价优惠	川西/ns,成都/ns
安徽长丰的古道，有开发成自驾游路线价值吗？	长丰/ns,安徽/ns
河北8个5A景区，你去过几个？更喜欢哪里？	河北/ns
如何看待5月19日五台山景区免票12小时？	五台山/ns
长春至延边线路上榜全国18条经典自驾游线路	延边/ns,长春/ns
阿坝州旅游景区卖的牦牛肉干是真的还是假的？	阿坝州/ns
Y858｜贺州市姑婆山景区有限公司招聘简章	贺州市/ns,贺州市/ns,有限公司/nt,有限公司/nt
国庆想去广州三日游，该怎样制定旅游攻略呢？	广州/ns
浙江湖州：提升乡村环境 推进村庄“景区化”	浙江/ns,湖州/ns
赏美景品文化，北京这个3A景区绝不能错过！	北京/ns
6条自驾游路线，让你GET到中国到底有多美	中国/ns
成都打通景区林盘发展 带动百亿旅游产业升级	成都/ns
山西最具影响力十大景区出炉！你都去过了吗？	山西/ns
济宁景区联盟：交流创新经验 促旅游商品发展	济宁/ns,景区联盟/nt
绵阳又增加三家4A级景区了，你收入增加没？	绵阳/ns
池州：28家A级景区面向安徽人分期免费开放	池州/ns,安徽/ns
在山东自驾游，有什么好的路线和景点推荐吗？	山东/ns
中国又一免费景区开始收门票，而且还不便宜！	中国/ns
天津一日游，有什么免费、好玩的地方推荐吗？	天津/ns
济宁首个生态厕所亮相微山湖景区 废水可养鱼	微山湖/ns,济宁/ns
世界上最古老的海炮岸成为厦门人气最旺的景区	厦门/ns
夏日游山玩水，怎能错过广东肇庆的这几个地方	肇庆/ns,广东/ns
山西7个5A景区，你去过几个？更喜欢哪里？	山西/ns
宁夏23家4A级以上景区门票向福建游客免费	宁夏/ns,福建/ns
黑龙江这些5A景区你都知道嘛，去过几个呢？	黑龙江/ns
四川乐山峨眉山五日自驾游，该如何规划行程？	四川/ns,乐山/ns,峨眉山/ns
大惊喜！母亲节快到啦！临城景区推出优惠活动！	临城/ns
革命圣地会宁如何打造经典景区、彰显红色名片？	会宁/ns
湖南郴州：4A级景区金贵白银成工业旅游新贵族	湖南/ns,郴州/ns
厉害了！渭南又多了个4A景区，快看你去过没？	渭南/ns
“5.19”中国旅游日五台山景区车辆预约公告	五台山/ns,中国/ns
「科普一日游」走进帽天山，探索“生命的起源”	天山/ns
四川："5.12"剑门关、翠云廊景区免费开放	四川/ns
四川成都18日起22个景区实行开放日免费游览	四川/ns,成都/ns
四川乐山、峨眉山五日自驾游，该如何规划行程？	四川/ns,乐山/ns,峨眉山/ns
五一旅游旺季之后，华山景区的门票价会下调吗？	华山/ns
西安汉城湖景区，只因有他21.5米――汉武帝	湖景区/ns,西安/ns
喜讯：5月19日市民可半价游阜阳景区 快来玩	阜阳/ns
香溪洞和瀛湖景区停车费获批复 将采取计次收费	湖景区/ns
忻州有多少个4A级和5A级景区？分别是哪些？	忻州/ns
央视曝光太原蒙山脏乱差 游客叹景区收费不管理	太原/ns,蒙山/ns
游客投诉三清山景区黑车扎堆 抢客超载情况严重	三清山/ns
云南9日11时-10日11日时部分风景区预报	云南/ns
云南怒江最美的九大景点，自驾游必去的打卡之地	云南/ns,怒江/ns
再过9天，晋城这些景区免费啦！包括历山……！	晋城/ns
自由行：重庆到成都 5日游，来听小编写故事？	成都/ns,重庆/ns
5月18日起 成都22个景区开放日可免费游览	成都/ns
池州28家A级景区面向安徽人推出分期免费活动	池州/ns
川西环线租车价格多少钱一天？自驾游需要几天？	川西/ns
广西首个！贵港哪个4A级景区向警察免费开放呢？	广西/ns,贵港/ns
中国游客在越南遇高价宰客 是个案还是普遍现象？	中国/ns
全国首个国家5A级景区长白山对全国公安民警开放	长白山/ns
你去过西藏吗？自驾游西藏圆你一个梦「南昌出发」	西藏/ns,南昌/ns
深圳求水山景区游乐场周末亲子游打卡游玩路线推荐	深圳/ns
「海南南北行旅业」打开海南的正确方式——自驾游	海南/ns
母亲节，河南这些景区免门票！这次必须有开封的！	河南/ns
母亲节带着爸妈去旅行，河南这些景区优惠大放送！	河南/ns
四川这些景区5月12日起有优惠 详细情况瞧这里	四川/ns
河南这个景区，因为改了个名，一年四季，游客罕见	河南/ns
新疆这些风景区 不光景色优美，而且还是免费游玩	新疆/ns
泰州中航国旅推出苏州+杭州+乌镇西栅夜景2日游	苏州/ns,杭州/ns,乌镇/ns,泰州/ns
感恩援建，回馈社会，这周开始四川部分景区免费！	四川/ns
永嘉县全域旅游和5A景区创建每周战报（第5期）	永嘉县/ns
河南一景区，被誉“世界第九大奇迹”，你去过没？	河南/ns
北京立夏时节开启晴热模式 游客着夏装顶烈日游览	北京/ns
中国212个5A景区全在这里，存起来，慢慢走完！	中国/ns
“河南省十大最具影响力景区” 揭晓，你去过几个？	河南省/ns
海南各景区打科普牌：科普 旅游 让孩子“玩中学”	海南/ns
亲子三亚五日游——真正体验了热情，好客，乐于助人	三亚/ns
梦幻 喀纳斯湖、禾木乡、吐鲁番、 天池经典8日游	吐鲁番/ns,喀纳斯湖/ns,天池/ns
5月河南这些景区免门票！去不去先收藏肯定不会错！	河南/ns
2018春晚分会场之一，贵州这个村子成了网红景区	贵州/ns
济宁市游客服务中心19日启用 景区直通车同步开通	济宁市/ns
自驾游进藏第5天：乐山-峨眉山-雅安 356km	乐山/ns,峨眉山/ns,雅安/ns
海南各景区打科普牌：科普+旅游 让孩子“玩中学”	海南/ns
青海这个景区被誉为户外天堂，却因为游客太多而关闭	青海/ns
安康香溪洞和瀛湖景区停车费获批复 将采取计次收费	湖景区/ns
5月12日-5月13日 泸沽湖景区母亲节有优惠！	泸沽湖/ns
北京出发，非常适合周末自驾游的4条路线，京郊首选	京郊/ns,北京/ns
北京到安徽阜阳自驾，沿途有哪些值得去的自然景区？	安徽/ns,北京/ns,阜阳/ns
北京自驾游，走京新高速到新疆中途在哪里住宿合适？	北京/ns,新疆/ns
吉林省6个5A景区，你去过几个？哪里印象最深刻？	吉林省/ns
中国旅游影响力调查：嵩山少林景区影响力居河南榜首	河南/ns,中国/ns,嵩山/ns
泰州中航旅游杭州西湖、乌镇、大明山二日游298元	杭州/ns,西湖/ns,乌镇/ns,泰州/ns
杭州必去十大景区，去过七个的算合格，你去过几个？	杭州/ns
中国景区的最大赢家，门票收入从17万发展到1亿！	中国/ns
好消息！洛阳旅游年票新增添一个4A景区！快看看！	洛阳/ns
央视春晚捧红了贵州这个景区，从默默无闻到人人皆知	贵州/ns
新乡轿顶山母亲节钜惠：女性游客进景区门票免费啦！	新乡/ns
我想自驾游去青海、新疆和内蒙古，那边路况怎么样？	内蒙古/ns,青海/ns,新疆/ns
河北武安市七步沟景区乱象多，监管单位被指不作为？！	河北/ns,武安市/ns
行走乡土，诗画梅州——环月形山徒步、和山岩景区漫走	梅州/ns
青岛这些适合一日游的好去处，风景好而且都是免费的！	青岛/ns
黑嘴鸥、翘鼻麻鸭在辽河绿水湾风景区栖息享受初夏暖阳	辽河/ns
济南旅游景点，花样旅行，从这十件事开始，三王峪景区	济南/ns
“拉练”的重庆三日游——回津患上山城“美食后遗症”	重庆/ns
华山景区门票难得降价 但有效期却缩短为1天网友质疑	华山/ns
无锡鼋头渚，三国城，灵山风景区两天时间会不会很赶？	无锡/ns,灵山/ns
从深圳福田口岸或者黄冈口岸过香港，一日游怎么玩呢？	香港/ns,深圳/ns
泰州中航旅游推出常州淹城春秋主题乐园一日游218元	常州/ns,泰州/ns
肥西首届蚕桑文化节开幕 国家4A级景区铭传故里揭牌	肥西/ns
郑州嵩山少林景区荣获河南省十大最具影响力景区第一名	郑州/ns,河南省/ns,嵩山/ns
几月份适合自驾游去新疆伊犁，都有哪些值得去的景点？	伊犁/ns,新疆/ns
23家4A级以上景区免门票 闽籍游客凭身份证游宁夏	宁夏/ns
中国古建筑名胜古迹旅游景区，古都中的古刹——华严寺	中国/ns
西安最雷人的景区，网友：这和周代都城能有多少相似？	西安/ns
西安出发成团含全陪：“快逸成都”超值动车往返三日游	西安/ns,成都/ns
云南玉龙雪山省级自然保护区，全国首批5A级旅游景区	玉龙雪山/ns,云南/ns
安徽九华山将对阜阳人免费！除此之外还有这些景区……	安徽/ns
一条路一边是海一边是山！浙江的这个景区很适合自驾游	浙江/ns
闽籍游客到宁夏凭身份证享23家4A级以上景区免门票	宁夏/ns
安徽有14家4A景区没有通过考核，都有什么问题呢？	安徽/ns
京北一日游——滩涂、峡谷、群山、花海、草原齐聚这里	花海/ns
忽悠游客“低价进景区” 三亚一“拉客仔”被行拘十日	三亚/ns
北有瘦西湖，南有古三湾！扬州又一4A级景区呼之欲出	三湾/ns,瘦西湖/ns,扬州/ns
乌鲁木齐将有一大波景区“大放价”，错过又要等一年！	乌鲁木齐/ns
重庆十大旅游景区，去过七个的算合格，全去过的太幸福了	重庆/ns
河南最迷人的两个景区，不算知名但风景太美！超适合周末	河南/ns
别说没时间旅游！乌鲁木齐周边这些地方1天也能自驾游！	乌鲁木齐/ns
骑单车，吃美食，看海景，厦门最值得体验的一日游在这里	厦门/ns
山西最具影响力十大景区调查结果公布！晋城一景区入选！	山西/ns,晋城/ns
云南省有多少个4A级和5A级景区?分别是哪些?在哪？	云南省/ns
中国最美丽的25个5A级景区是哪些，台湾有哪个入选？	中国/ns
中国最低调的5A景区，坚持不收门票，物价低得不敢相信	中国/ns
福利来来一波丨“5·19”中国旅游日，木格措景区免票	中国/ns
泰州中航旅行社推出南京牛首胜境、佛顶宫一日游148元	佛顶宫/ns,南京/ns,泰州/ns,中航旅行社/nt
全中国知名但“超级坑”的4个景区，为什么游客还要去？	中国/ns
优惠｜免费！河北这两地景区免费or半价，错过绝对后悔	河北/ns
这些被国家点名的西部自驾游路线，霸占了中国一半的美！	中国/ns
三亚“最坑”的景区，两块石头门票95元，你还想来吗？	三亚/ns
长汀连城两日游，走过古城，探访培田古民居，登顶冠豸山	连城/ns,长汀/ns
继小雅公园后，三湖连江风景区新添“长虹卧波”新景观！	连江/ns
济宁景区联盟旅游商品工作创新经验交流会在曲阜隆重召开	济宁/ns,曲阜/ns,景区联盟/nt
投资90亿，苏州这个5A级景区，景美还免费，你去过吗	苏州/ns
科普+旅游新模式 海南各景区大打“科普牌”助推亲子游	海南/ns
贵州这座山被切成两半，如今成为4A级景区，你去过吗？	贵州/ns
“黄金水果”采摘节+自驾游观光，耒阳乡村旅游大有搞头	耒阳/ns
“一部手机游甘肃”宣传语征集，奖景区门票、酒店住宿！	甘肃/ns
为迎接“护士节”和“母亲节”，河南景区一大波福利袭来	河南/ns
河南门票最贵的景区：票价210，不知道你去过没有呢？	河南/ns
河南旅游优惠信息：免票！至6月底！宝泉景区，嗨翻天！	河南/ns
您知道深圳农家乐、周边游、一日游可以有这么个地方玩！	深圳/ns
重庆一景区推出巨型悬崖秋千 打造互联网时代旅游新名片	重庆/ns
自驾e族山西总会阳泉分会活动｜游览红色革命景区沂山圣地	山西/ns
泸沽湖景区母亲节推出专属优惠 60岁以上女性免费进景区	泸沽湖/ns
天台山景区：全面增强景区吸引力，实现旅游收入的持续增长	天台山/ns
40公里内，集中了9个景区，堪称河南之最，而且全部免费	河南/ns
5月19日，山西这47个景点免门票，晋城4家景区入列！	山西/ns,晋城/ns
贵州这座山被天地劈成了两半，却是国家AAAA级旅游景区	贵州/ns
佛山创建放心消费旅游景区试点，以后这些景区可放心消费！	佛山/ns
河南又一个景区准备收费了，风景如画，再不去就来不及了！	河南/ns
推广泉水大碗茶、WiFi全覆盖……济南要对景区做这些！	济南/ns
太原蒙山景区“乱象丛生”，直接被央视曝光了！你遇到过么	太原/ns,蒙山/ns
山东景区厕所再创新高，成为中国景区厕所建设数量第一名！	中国/ns,山东/ns
秒杀任何景区：三处免费处女地，火遍了河南驴友圈！可自驾	河南/ns
号外！号外！5.19日中国旅游日仓颉庙景区免费开放啦！	中国/ns
云南省5月6日11时至5月7日11时部分风景区天气预报	云南省/ns
云南省12日11时至13日11时省内部分风景区天气预报	云南省/ns
湖北宜昌，国家环境保护模范城市，4处国家5A级旅游景区	湖北/ns,宜昌/ns
中国5A级景区门票最高价格前十名，看看你都去过哪几个？	中国/ns
湖北宜昌，4处国家5A级旅游景区，国家环境保护模范城市	湖北/ns,宜昌/ns
今天你看见雨后彩虹了吗？南岳衡山景区惊现奇美“双彩虹”	衡山/ns
中国最亲民的旅游城市，每年有4亿游客前往，从来不宰客！	中国/ns
重庆各大景区将有大变动！是持续红的节奏！未来发展要逆天	重庆/ns
河南省最贵的景区，门票是很多景区的几倍，网友却称赞很值	河南省/ns
爱酒人不去后悔终生！中国最不可思议酒厂 车间是国家级景区	中国/ns
排名：大槐树景区3天门票收入257万元！但第一名却不是它	大槐树/ns
攀爬雕像、随地大小便，“五一”沈阳景区这些现象你怎么看？	沈阳/ns
来成都的这五个地方感受蜀文化吧，最后一个是国家4A级景区	成都/ns
九华山、牯牛降……28家A级景区，34开头安徽人免费玩！	安徽/ns
全球最大地下人工洞穴：曾是中国军事绝密，如今被改建成景区	中国/ns
河南省最另类的景区，票价超200元，每年这一天只赚男人钱	河南省/ns
河南省最具影响力的10大景区，你去过几个？你最喜欢哪个？	河南省/ns
河南省最贵的景区，门票是很多景区的几倍，网友却称赞很值！	河南省/ns
听到没有？河南这个美丽有爱的景区喊你爸爸妈妈去免费旅游呢	河南/ns
河南一个最贵的景区：门票价210元，不知道你去过没有呢？	河南/ns
西安这些高规格的地方，即使是节假日游客也不多，值得去打卡	西安/ns
母亲节陕西这些景区免费、半价或优惠，就是要把妈妈宠上天！	陕西/ns
要羡煞众人！河南5A景区数竟排全国第三？但门票却差了太多	河南/ns
伊犁·那拉提大草原、巴音布鲁克天鹅湖、吐鲁番、天池7日游	天池/ns,巴音/ns,吐鲁番/ns,天鹅湖/ns,伊犁/ns
感恩援建恩情 青城山-都江堰景区再次推出上海市民优惠政策	都江堰/ns,上海/ns
感恩有你！四川多个景区推出旅游感恩优惠，部分景区免收门票	四川/ns
福建浦城县第一期乡村旅游从业人员培训班在小密景区开班啦！	福建/ns,浦城县/ns
第七届上海国际自驾游与房车露营博览会将于5月19上海举办	上海/ns
赤峰又多一家特色景区！总投资59亿元，快来看看在哪儿吧！	赤峰/ns
成都自驾游云南，行程时间6-7天，有什么好的路线推荐吗？	成都/ns,云南/ns
中国最不赚钱的旅游城市，每年接待4亿游客，不宰客无黑导游	中国/ns
中国最良心的5A景区，景色美且统统不收门票，你去过几个？	中国/ns
被污染的圣地，网友：不愧是“中国最坑的十大旅游景区”之首	中国/ns
下周末！山西47个大景区免费！五台山、云冈石窟、鹳雀楼……	五台山/ns,鹳雀楼/ns,山西/ns
最美的中国火车站，建设在4A级景区内，下车的乘客眼都直了！	中国/ns
「曝光」河北武安市七步沟景区乱象多，监管单位被指不作为？！	河北/ns,武安市/ns
5月19日山西省内这些景区全部免门票，看看有没有你想去的？	山西省/ns
旅游攻略｜深圳一日游免费游玩地，不要再说你的周末很无聊了！	深圳/ns
国家AAAA级旅游景区——白水县林皋慢城旅游区举行揭牌仪式	白水县/ns
河南5A景区 河南国家级5A景区名单 河南有哪些5A级景区	河南/ns
2018池州旅游景区免费开放周 28家A级景区安徽人免费玩	池州/ns
3个5A级景区被撤称号，19个被严重警告，其中一个在重庆！	重庆/ns
持续免票11个月！成都周边23处景区发福利，每个人都有份！	成都/ns
幸福踏青季 京北一日游——春天的八达岭孔雀城，到底有多美？	八达岭/ns
秀丽多姿的山川溪水——浦江茜溪，金华人夏天最爱的旅游风景区	浦江/ns
转过身才能看见西藏最美的雪景——南迦巴瓦峰珠峰大本营一日游	西藏/ns
四川省这个城市，5月将有9个景区免费开放，有你喜欢的景区吗	四川省/ns
成了网红的重庆，没有宰客，没有黑商贩，此生一定要来的这里！	重庆/ns
网传旅游日山西47个景区免费的消息不实，真正免费的是这些！	山西/ns
去宁夏看沙湖，宁夏的沙湖生态旅游风景区以“塞上明珠”的声誉	宁夏/ns,沙湖/ns
中国名声最差的5A级旅游景区，去过的人都很后悔，你去过吗？	中国/ns
江苏5A景区 江苏国家级5A景区名单 江苏有哪些5A级景区	江苏/ns
江西5A景区 江西国家级5A景区名单 江西有哪些5A级景区	江西/ns
这个景区从不收任何门票它就是青州古城，一个牛肉煎包都很便宜	青州/ns
成都20多个景区免费，只需提前预约即可，网友：这有什么用呢	成都/ns
河南小镇真牛叉，独家拥有6大景区，其中2个是5A、4A景区	河南/ns
江西设220万人次入境游“小目标” 5A景区对境外游客免票	江西/ns
倒计时11天！阜阳这些景区全部半价！省级以上劳模还可以……	阜阳/ns
隔壁重庆的洪崖彻底火了，成都的第一网红景区表示“不服气”！	成都/ns,重庆/ns
下一个凤凰古城？中国又一免费景区开始收门票，而且还不便宜！	中国/ns
中国最尴尬旅游省份：国家级景区数量全国第一，游客却仅全国第六	中国/ns
中国最可惜的景区，曾经是世界最强王朝的首都，如今免费都没人去	中国/ns
中国最值得去5大景区，有生之年必去一次的地方，你去过几个了？	中国/ns
海螺沟景区管理局关于“5.19”中国旅游日门票优惠政策的通告	中国/ns
藏北草原的珍珠，中国最美丽湖泊之一，自驾游西藏不可错过的风景	中国/ns,西藏/ns
重磅！滨州“蒲湖景区”大动作！亲水平台木栈道雨水花园值得期待	滨州/ns,湖景区/ns
我们的西藏自驾游车队今天早上来到天湖纳木错，积雪还未完全消融	西藏/ns
阆（làng）中古城，是国家AAAAA级旅游景区，四川欢迎您	四川/ns
亳州这个博物馆建成仅四年，对外开放第三年被评为国家4A级景区	亳州/ns
盘点柳州最值得去的汽车营地（一）——柳城红马山景区自驾车营地	马山/ns,柳城/ns,柳州/ns
广州游记——景点暴走篇 两日游 博物馆/寺庙/美术馆/小蛮腰	广州/ns
北有瘦西湖，南有古三湾！运河三湾风景区年内争创国家4A级景区	三湾/ns,瘦西湖/ns
渭北高原上耀眼的明珠 白水林皋慢城跨入国家4A级旅游景区行列	渭北/ns
泰州中航国旅推出无锡灵山大佛、吉祥新梵宫、祈福一日游238元	无锡/ns,泰州/ns,灵山/ns
泰州中航国旅推出横店追剧游横店影视城探秘、追剧探班品质二日游	横店/ns,泰州/ns
四点联动 劲爆九华 辽西九华山景区“五一”小长假活动精彩纷呈	辽西/ns
武汉周边景区最全免费名单出炉！母亲节，带妈妈来一场完美的旅行	武汉/ns
华山景区门票降价了！看看陕西的这些景区门票 真的该好好降价了	陕西/ns,华山/ns
辉县一景区，被誉“亚洲一绝”，却因各种观光费，遭游客疯狂吐槽	亚洲/ns
活动召集！抢鲜体验！韶关免费景区新玩法，90%的人都无法拒绝	韶关/ns
山西47个大景区免费！下周末！五台山、鹳雀楼……错过等一年！	五台山/ns,鹳雀楼/ns,山西/ns
江苏最“尴尬”5A景区，曾经被严重警告，差点5A头衔被摘牌！	江苏/ns
发福利｜安徽市民赶紧做好准备，池州旅游景区免费开放周即将到来	池州/ns,安徽/ns
从北京想去周边自驾游，往返共四天，有哪些好玩的地方可以推荐？	北京/ns
杭州的西湖传片天下，你却没听过徐州的5A景区，阴雨下的别样美	杭州/ns,西湖/ns,徐州/ns
塞班岛这个未经开发的景区却有无数游客前往，只为看一眼“鳄鱼”	塞班岛/ns
成都周边这20个热门景区免费耍！90%的人都不知道，火速收藏	成都/ns
精选丨甘州区滨河新区食药监所开展旅游景区及周边食品安全大检查	甘州区/ns
成都20多个景区免费，只需提前预约即可，网友：这有什么用呢？	成都/ns
中国“最不坑”的5A景区，从不收任何门票，包子只要7毛钱一个	中国/ns
中国213个5A级景区，你去过多少个？转给身边爱旅游的TA!	中国/ns
湘窖生态文化酿酒城荣膺湖南省首个酒文化主题国家AAAA级景区	湖南省/ns
中国名气很大的6个景区，本地人称“又贵又无聊”，有你去过的吗	中国/ns
产业融合 校企“联姻”打造佛教圣地五台山景区研学旅行示范基地	五台山/ns
中国又一免费景区开始收门票，位于广西，网友：下一个凤凰古城？	中国/ns,广西/ns
中国最霸气的景区：曾经无数网友为它点赞，如今遭不少游客吐槽！	中国/ns
五一长白山看到游客不文明行为，对个人是小事，对景区就是风险！	长白山/ns
中国最不赚钱旅游城市：游客多收入少，网友：因为不宰客无黑导游	中国/ns
江西最热门国家级景区：门票高达260元，一年接待1324万人次	江西/ns
河南两座最“不相同”景区，1座连空气都想收费，1座想玩多久随你	河南/ns
从乐山到青海湖自驾游4人，行程怎么安排，全程平均每人多少费用？	乐山/ns,青海湖/ns
郑州这条“臭河沟”要变5A级景区！音乐喷泉、儿童乐园等娱乐设备	郑州/ns
广州周边这47个热门景区免费耍！90%的人都不知道，火速收藏！	广州/ns
免费！成都这些景区发福利！持续免票11个月！收下这波旅游攻略！	成都/ns
泰州中航国旅推出诸暨五泄飞瀑横店影视城梦幻谷休闲三日游698元	诸暨/ns,横店/ns,泰州/ns
够劲爆！母亲节河南这10家景区免费了！送给妈妈们最好的旅行礼物	河南/ns
泰州中航推出上海野生动物园科技馆、海洋水族馆亲子二日游418元	泰州/ns,海洋水族馆/nt
安徽省这个县城博物馆建成仅四年时间，第三年被评为国家4A级景区	安徽省/ns,县城博物馆/nt
成都22个景点有机会免费玩青城山都江堰景区免费一个月记得预约哦	都江堰/ns,成都/ns
仅仅几个月，云南有10家景区被取消A级等级资质，你曾经去过吗？	云南/ns
佛山这些地方要创建成放心消费示范景区啦！快看看有没有你熟悉的？	佛山/ns
中国这所大学位于5A级景区，学生每天可以在青山绿水中学习 太美	中国/ns
中国最“良心”的5A景区，不收取任何门票，吃个包子只要7毛钱！	中国/ns
深圳欢乐谷——华侨城集团新一代大型主题乐园，首批国家5A级景区	深圳/ns
“5·19”中国旅游日，悬空寺、恒山、云冈石窟景区门票有优惠！	中国/ns
湖南湘水缘颠覆传统发展模式 “生态景区+休闲养生”构筑特色小镇	湖南/ns
身为国家5A级旅游景区却不收门票免费开放，潍坊这个景点值得点赞	潍坊/ns
这两座山名字一样，都是国家5A级景区，一座在河南，一座在广东！	河南/ns,广东/ns
泰州中航国旅推出无锡三国城、水浒城、船游太湖纯玩一日游178元	无锡/ns,太湖/ns,泰州/ns
泰州中航国旅推出无锡动物园太湖欢乐园、海洋馆亲子一日游178元	泰州/ns
四川省两大伟人故里，现为免费的5A级景区，每逢小长假人山人海！	四川省/ns
成都周边这20个热门景区免费耍！90%的人都不知道，火速收藏！	成都/ns
五台山景区“5.19”中国旅游日期间生产、生活车辆通行证办理通知	五台山/ns,中国/ns
河南10个景区门票都超100元，第一更是高的离谱！看看你去过没！	河南/ns
福州亲子五日游，赶海+海洋世界+云顶，五星纯玩，成人2690起！	福州/ns
贵州的这个4A级景区，非常可惜，当地人：全国至少一半5A都不如它	贵州/ns
西宁1小时半直达！只要100元起，42个景区正在打折，不去太亏！	西宁/ns
中国最好的212个5A级景区全在这里，你去过多少个？快收藏起来！	中国/ns
旅游文化：2018中国旅游景点大全！2018年旅游风景区有哪些？	中国/ns
泰州中航旅游推出淮安极地海洋馆冰雕，恒温水世界纯玩一日游198元	泰州/ns,淮安极地海洋馆/nt
你有福建身份证？那你爽了！6月30日前这些4A级以上景区免费玩！	福建/ns
中国最笨的城市，一年接待5.42亿游客，却不懂宰客，就赚一点钱！	中国/ns
江西最热门国家级景区：被评国内声誉最好景区，一年接待1324万人	江西/ns
中国最贵的一个景区，门票3500，进入需提前申请，你知道在哪里吗	中国/ns
浙江该市近20个5A级景区免费开放，一年门票损失数十亿，值得吗？	浙江/ns
南京地铁口 嘉恒有山别墅 金牛湖景区 总价198万起住嘉恒有山别墅	南京/ns
创建一个5A景区奖励300万元！港北区旅游发展扶持奖励办法（试行）	港北区/ns
河北周边最全44个AAAAA级景区，存起来，挨个走完！人生完美了！	河北/ns
5.19旅游日，恰逢周末，山西47个景区免费！你会去“凑热闹”吗？	山西/ns
国内5A景区最多的省排名，浙江16个，河南13个，排名第一的有23个	河南/ns,浙江/ns
有生之年必须要自驾游去一次西藏，如果去的话需要准备什么，需要带多少钱？	西藏/ns
景区买了一百个双黄鸭蛋，回家发现全是假的，怎么看待沈阳老人遇到的这件糟心事？	沈阳/ns
喜讯！青城山—都江堰景区游客中心导游管理所荣获“四川省五一巾帼标兵岗”称号~	都江堰/ns,四川省/ns
想在山东省内来个七天自驾游，各位推荐一下路线，各地景点的顺序，以及费用可以吗？	山东省/ns
我和老婆二人开奥拓从邢台市到布达拉宫自驾游，路上花销大概多少，需要带什么必备物资？	布达拉宫/ns,邢台市/ns
南充所有5A、4A级景区放大招，门票免费或半价让您敞开耍，欢迎全国的朋友来体验……	南充/ns
玉泉区景区管理办公室联合玉泉交管景区中队强化旅游景区周边道路交通秩序整治积极做好旅游旺季交通安保工作	玉泉区/ns,玉泉交管景区中队/nt,景区管理办公室/nt
5月13日，格萨拉4A级景区免门票自助旅游新模式 “时尚元素+美景美食美音”：盐边县2018索玛花节绽放格萨拉	盐边县/ns
郑州租房记	郑州/ns
上海部分二手房降价	上海/ns
广东房贷如何计算？	广东/ns
郑州租房价格降了吗？	郑州/ns
珠海 哪里租房便宜？	珠海/ns
重庆必会成为炒房的坟场	重庆/ns
杭州西湖区租房多少钱？	杭州/ns,西湖区/ns
德阳万达商品房怎么样？	德阳/ns
无锡商品房保证期是多久？	无锡/ns
威海现在二手房什么价格？	威海/ns
北京二手房市场悄然回暖？	北京/ns
「深度」丹东炒房五大警示	丹东/ns
郑州为什么租房子的少了？	郑州/ns
兰州最高端的房产在哪里？	兰州/ns
安平县商品房预售许可证公示	安平县/ns
邯郸申请工租房有哪些条件？	邯郸/ns
威海二手房哪个小区比较好？	威海/ns
重庆有哪些大点的房产中介？	重庆/ns
香港如何构建房地产税制度？	香港/ns
郑州房产中介到底有多坑爹？	郑州/ns
河北公积金3市还有这些新变化	河北/ns
五年后，北京的房租会翻倍吗？	北京/ns
哈尔滨二手房房价大概是多少？	哈尔滨/ns
现在海南三亚对二手房限购吗？	三亚/ns,海南/ns
杭州二手房市场今年走向如何？	杭州/ns
绿地集团杭州湾期房值得买吗？	杭州湾/ns
珲春市房产交易量实现高位增长	珲春市/ns
太原买二手房好还是买期房好？	太原/ns
溧阳金坛多处房产白菜价拍卖！	溧阳/ns
菏泽房产网4月楼市月报出炉！	菏泽/ns
南京房地产交易税费大全（住宅）	南京/ns
无房产&有房产办理入户广州攻略	广州/ns
南京上周二手房交易量“大跳水”	南京/ns,大跳水/ns
为什么海南不能建更多的房地产？	海南/ns
在昆明做房地产销售的前景如何？	昆明/ns
无锡在哪里租房的居住性价比高？	无锡/ns
武汉商贷转公积金的流程是什么？	武汉/ns
湖北将集中排查房地产领域非法集资	湖北/ns
贵阳的房地产有多火，将往何处去？	贵阳/ns
现在还合适在广东江门买二手房吗？	广东/ns,江门/ns
用四象图分析链家武汉市二手房数据	武汉市/ns
政策加强调控房产市场，北京首试水	北京/ns
没有公积金，在西安买房如何贷款？	西安/ns
在德阳一直租房住，不买房现实吗？	德阳/ns
徐州新城区房产现在还适合投资吗？	徐州/ns,新城区/ns
内地人购买香港房产时，有何限制？	香港/ns
2018年4月份 泉州房地产情况	泉州/ns
广西柳州商品房2018会大降价吗？	广西/ns,柳州/ns
西安房贷3500，30年压力大吗？	西安/ns
2018年5月11日厦门二手房成交	厦门/ns
河北：今后办理住房公积金更加电子化	河北/ns
连云港市单位公积金业务实现网上办理	连云港市/ns
北京租房，要花多少钱才能过的很好？	北京/ns
敢在成都租房的人，才是真正的勇士！	成都/ns
晋中恒大华府让全城购房者不淡定啦！	晋中/ns
北京首套贷利率上调 公积金贷款受捧	北京/ns
深圳4月购房者大数据报告，请查收~	深圳/ns
现在的杭州，房价房租不可承受的痛！	杭州/ns
天价二手房，让西安诞生百万富翁……	西安/ns
现在在重庆投资房产还有升值空间吗？	重庆/ns
为什么海南的二手房会出现有价无市？	海南/ns
深圳布吉哪些地方有旧改拆迁的项目？	深圳/ns
湖南提高征地补偿标准 普遍上调30%	湖南/ns
呼和浩特办理公积金业务只提供原件即可	呼和浩特/ns
井冈山地产网是一家房地产综合门户网站	井冈山/ns
安福县地产网是一家房地产综合门户网站	安福县/ns
遂川县地产网是一家房地产综合门户网站	遂川县/ns
兰州四部门联合开展房地产市场专项检查	兰州/ns
目前海南房地产的限购政策主要有哪些？	海南/ns
深圳旁边的惠州，值不值得投资房产呢？	惠州/ns,深圳/ns
如何看待现在重庆房地产一房难求的现象？	重庆/ns
永州查处一发布迷信广告的商品房销售公司	永州/ns,销售公司/nt
公积金贷款放大招 武汉二手房楼市再升温	武汉/ns
郑州租房需要注意的几个套路，郑州人必看	郑州/ns
炒房者自述在中国没人为买房而倾家荡产？	中国/ns
最新消息，贵阳公积金买房将发生重大变化	贵阳/ns
碧桂园横空入市泗县！泗县房产要火爆了！	泗县/ns
武汉公积金贷款首套房额度提升至70万元	武汉/ns
深圳炒房的人现在都怎么样了？套现了吗？	深圳/ns
西安的二手房现在什么价格，值得入手吗？	西安/ns
我在苏州交的公积金，能回盱眙买房用吗？	苏州/ns,盱眙/ns
海南新房限购，买二手房会是个好选择吗？	海南/ns
一季度广州商品房销售面积同比现“腰斩”	广州/ns
2018年 宁波房地产的热点板块在哪里？	宁波/ns
在北京全款买二手房，不经过中介有风险吗？	北京/ns
长沙三部门公布限价商品房销售价格监制流程	长沙/ns
外地人想投资太仓，投资哪里房产最有潜力？	太仓/ns
房地产业“金三银四” 福州新房成交较清淡	福州/ns
移民美国后，中国房产出售需要交美国税吗？	中国/ns
成都5月新房摇号“狂欢” 二手房成交平稳	成都/ns
太原二手房源抢手，小店区房子最受欢迎？！	太原/ns,小店区/ns
重磅！东莞新建商品房价格一经备案不得上调	东莞/ns
广州哪里租房便宜又方便？「内附租房指南」	广州/ns
从北京新政看淄博房产：房价管控加强是趋势	淄博/ns,北京/ns
深圳房价“19连跌”，二手房成交量上升！	深圳/ns
1.6亿！淮安最大一宗房产遭二次司法拍卖	淮安/ns
牡丹江市2018年4月二手房价格数据分析	牡丹江市/ns
为什么贵阳观山湖的房价比贵阳老城区的高？	贵阳/ns,老城区/ns
开发商抢地还抢人！南阳房地产市场要开挂！	南阳/ns
购房者需看：四大行上调北京首套房贷款利率	北京/ns,四大行/nt
北京或环京地区的房产，哪些具备投资价值？	北京/ns
临沂公积金新规来了 每月可自动转还款账户	临沂/ns
北京二手房市场观察：成交量回升 价格企稳	北京/ns
南京买卖二手房，原户口，可以强制迁走吗？	南京/ns
办理希腊购房移民，购买哪里的房产比较划算？	希腊/ns
新疆去年发放住房公积金个贷152.12亿元	新疆/ns
21世纪不动产携手济南聚隆房产进驻山东聊城	济南/ns,山东/ns,聊城/ns
7月1日起 贵阳市个人公积金贷款政策有调整	贵阳市/ns
还敢炒房？！青岛这个区域严查捂盘、倒房号！	青岛/ns
郑州公积金贷款新规：审批7个工作日内要完成	郑州/ns
杭州的房租，杭州的工资，感觉没有一样属于我	杭州/ns,杭州/ns
绵阳公积金怎么提取 满足这10个条件即可！	绵阳/ns
房产投资为了自住or投资？广州买房权重分析	广州/ns
2018贵阳房地产交易展示会打造一条龙服务	贵阳/ns
武汉4月二手房继续上涨，涨的最快的是这个区	武汉/ns
成都二手房要逆天！一套二手房要顶两套新房！	成都/ns
成都工商严查房产虚假广告，这个盘被罚50万！	成都/ns
中国开展治理违规提取公积金：防止用于炒房投机	中国/ns
2018最新濮阳公积金贷款额度计算方式出炉！	濮阳/ns
山西：一季度商品房待售面积减少148万平方米	山西/ns
发展住房租赁 天津满足条件租房也可使用公积金	天津/ns
中小房企危机：靠上市突围 抢夺房地产最后门票	上市/ns
福州公积金管理中心提醒：一人多账户将强制并户	福州/ns,公积金管理中心/nt
动真格！四大行上调北京首套房贷款利率严控炒房	北京/ns,四大行/nt
日本房产贷款——连带债务者和连带保证人的区别	日本/ns
2018濮阳市龙都广电房产文化节即将盛大开幕	濮阳市/ns
澳洲房产真的会降么？看来大家还是很明事理的！	澳洲/ns
海南加强商品房交易合同网签备案管理和税收征管	海南/ns
调控年“房价”岌岌可危 阜阳购房者霎时惊醒！	阜阳/ns
楼市重大消息，投资炒房将中国房价炒高两三倍！	中国/ns
「拍卖二」城厢区法院拍卖5处房产，速来关注！	城厢区/ns
都在这里！武汉公积金贷款新政你最关心的问题！	武汉/ns
西安买房攻略 图解二手房公积金贷款条件及流程	西安/ns
哈尔滨收紧楼市政策 新购商品房3年内不得销售	哈尔滨/ns
哈尔滨新购商品房限售出台，房贷利率还会上浮么？	哈尔滨/ns
聊城的业主，你了解房产税和房地产税是不一样的吗	聊城/ns
资金监管窗口前移 常州二手房交易创新举措再便民	常州/ns
2018年5月11日，牡丹江市商品房成交34套	牡丹江市/ns
北京住房公积金单位网上注册教程20180510	北京/ns,住房公积金单位/nt
经济观察：中国专家预料未来房地产调控会持续加码	中国/ns
成都购房者不必慌 比起北上广成都购房难度小太多	成都/ns
郑州的房产限购令，会在2018年元月份解除吗？	郑州/ns
泰安：连续缴存3个月公积金无房者可提取支付房租	泰安/ns
「购房问答」厦门二手房降价 漳州市场会跟风吗？	漳州/ns,厦门/ns
在深圳这样的一线大都市，是买房好还是租房好呢？	深圳/ns
甘肃省老旧住宅小区增设电梯业主可申请提取公积金	甘肃省/ns
揭秘炒房团背后的秘密，对比淄博的情况，吓一跳！	淄博/ns
在淄博工作和交公积金，能在临沂用公积金买房吗？	临沂/ns,淄博/ns
在太原，手里有100万，投资房产还是买理财产品？	太原/ns
长春市商品房成交价不得高于预售申报价，你怎么看？	长春市/ns
青岛房地产如此火爆还能持续多少年，高点是多少钱？	青岛/ns
杭州购房人涌向周边 海宁新房价同比上涨55.1%	杭州/ns,海宁/ns
房贷破“70年”上限，北京首套房贷利率至1.1倍	北京/ns
北京和深圳房价差不多，为什么租房价格却相差甚远？	北京/ns,深圳/ns
冰城出台限售令，售房者措手不及，炒房团欲哭无泪！	冰城/ns
南宁二套房贷利率再度上调 购房者表示“压力很大”	南宁/ns
泰安：连续缴存3个月公积金 无房者可提取支付房租	泰安/ns
成都楼市调研：新房二手房严重倒挂，全民为房癫狂！	成都/ns
深圳男子“买罪受”：家在南山有房却坚持出来租房住	南山/ns,深圳/ns
2018聊城住房公积金贷款问题全解析，收藏备用！	聊城/ns
2018年4月份泉州房地产情况 数据分析告诉你！	泉州/ns
趁早打消去澳洲炒房的念头吧！这里不适合中国炒房客	中国/ns,澳洲/ns
晋江市二手住宅成交数据分析，泉州二手房成交量如何	晋江市/ns,泉州/ns
河北：住房公积金个人业务办理无需再提供身份证复印件	河北/ns
南京这一类名校学区房，最受买房人欢迎，超过拉力琅！	南京/ns
预测：房地产税将在这些城市率先征收（福州赫然在列）	福州/ns
重磅！贵阳公积金出新政，余额提取、商转公要求有变化	贵阳/ns
南阳发布整顿规范房地产工作方案，烂尾楼的末日到了！	南阳/ns
手上有100万在南京买新房，是买新房还是二手房呢？	南京/ns
杭州“最难摇”盘中签率仅3% 排队半日也没进售楼处	杭州/ns
西安二手房价飞速涨，个人间的房产买卖，怎么办过户？	西安/ns
除了武汉 湖北这些地方也调整了住房公积金、房贷政策	武汉/ns,湖北/ns
从身无分文到8位数身家房产，一个真实的深圳买房故事	深圳/ns
厦门一、二手房成交均陷低迷，二手房以价换量也难拯救	厦门/ns
成都加大商品住房供应 月内或推360万平方米商品房	成都/ns
中国的房地产到底怎么了？不要让房子成为我们的唯一！	中国/ns
成都新房和二手房差价越来越小，专家给出3点买房建议	成都/ns
杀死刚需，逼走投资客！淄博最具投资价值的房产在哪里？	淄博/ns
北京“限转共”重磅落地，这62个房地产项目的价值爆红	北京/ns
任大炮放狠话：中国房地产投资未过热，产商预将身败名裂	中国/ns,任大炮/nr
成都：限价太狠，限购太松，全民疯狂炒房后或将一地鸡毛	成都/ns
中国房地产公司500强前10名一览，恒大集团雄踞第一	中国/ns,房地产公司/nt
两三千一平的房子千万不要错过，成都经济适用房申请指南	成都/ns
甘肃省老旧住宅小区增设电梯 业主可申请提取住房公积金	甘肃省/ns
房东趁火打劫一天涨价15万，西安二手房价格倒挂严重！	西安/ns
襄阳调整住房公积金、房贷政策！不知道这些你就亏大了！	襄阳/ns
大浪淘沙的中国房地产十年 他们如何敌千军夺先机主沉浮	中国/ns
4.30～5.6无锡商品房一周备案成交8.67万平米	无锡/ns
重庆房地产趋势发布会举行 行业大咖发表房地产精彩观点	重庆/ns
5月7-20日部分时段，成都商品房网签系统等或受影响	成都/ns
房地产泡沫破裂27年后，日本现在的房价处于什么水平？	日本/ns
成都楼市难题并非调控孤例：二手房价格畸高最高炒到7万元	成都/ns
海南房产 ‖ 如果海南限购不松懈，三亚房价会不会下跌？	三亚/ns,海南/ns
东莞房价备案政策再升级！新建商品房价格一经备案不得上调	东莞/ns
广州四大行否认房贷利率上涨 首套房贷平均利率5.51%	广州/ns,四大行/nt
北京限价商品房五年之内禁止交易，对房地产市场有何影响？	北京/ns
济南上周商品房网签榜被大牌房企占据 新房网签环比降两成	济南/ns
上周东莞新房二手房量跌价升，新房热度高带看量上涨近5成	东莞/ns
昆明至少200余租户拖欠房租或被列入社会信用体系黑名单	昆明/ns,昆明/ns
晚读：青岛公积金新政实施 青岛今年要建百个“口袋公园”	青岛/ns
这才是真相！东北三四线新房价格虚高，二手房想转手很难！	东北/ns
上周西安商品房卖了6168套 均价10322元/平趋稳	西安/ns
任大炮大放狠话，中国房地产投资过热，产商或将身败名裂？	中国/ns,任大炮/nr
青岛：5月第一周新房和二手房成交量降五成 市场观望明显	青岛/ns
小心！成都被住建局再度约谈，或将是下一个炒房人的坟墓！	成都/ns
7月1日起，贵阳公积金贷款有新规！这些情况不得申请贷款	贵阳/ns
青岛新房二手房成交环比降幅超五成，买方卖方进入博弈状态	青岛/ns
河北多地公积金新政保刚需 你的公积金还在“睡大觉”吗？	河北/ns
深圳首个限价盘入市前，巨大价差会否成为炒房牟利的工具？	深圳/ns
山西：一季度商品房待售面积比上年末减少约148万平方米	山西/ns
中国近20年的房地产高速发展，对中国科技的影响有多大？	中国/ns
昆明商品住宅又出“限购令”?房产中介开发商均未接到通知	昆明/ns
为什么深圳租房，都是空房子，没有家具，床等还要自己买？	深圳/ns
中国房地产风云40年，曾经的海南崩盘时房价暴涨了多少？	中国/ns,海南/ns
股市温州帮代表失联，曾活跃地产界的温州炒房团现在怎样了？	温州/ns
住建部约谈成都背后：6万人抢640套房，二手房比新房还贵	成都/ns
滨州二手房交易出新政！这36家房产中介可办理免费网签业务	滨州/ns
韶关去年住房公积金缴存逾31亿，中、低收入职工群体成主力	韶关/ns
关于长春市商品房成交价不得高于预售申报价，这个你怎么看？	长春市/ns
杭州6家银行接通知，房子结顶才能放贷！购房者会受影响吗？	杭州/ns
「5.8」扬州商品房成交147套 建筑面积为17069㎡	扬州/ns
东莞宣布房价一经备案禁止上涨，房地产不准涨价时代来了吗？	东莞/ns
南京楼市一个新信号，买房人欣喜若狂，但房价却迎来大利空！	南京/ns
律师眼中的新版《浙江省商品房买卖合同示范文本》变化及影响	浙江省/ns
上周重庆商品房合计成交10888套 环比上涨47.75%	重庆/ns
上周西安商品房卖了6168套 均价10322元/平趋稳！	西安/ns
在西安进行二手房交易，卖家只要做好委托，可以全程不到场！	西安/ns
5月5日温州房产网签共200套 成交面积23593.3㎡	温州/ns
在上海有十套房，可以不用工作，靠收房租过着富豪的生活吗？	上海/ns
「5.11」扬州商品房成交117套 建筑面积为13063㎡	扬州/ns
千万元级二手房单日迎98波看房客 北京二手房市场悄然回暖？	北京/ns
南昌4月二手房均价11697元/㎡！多个热点板块房价出炉！	南昌/ns
谁能预测一下2018年邢台（三四五六线）房地产市场的形式？	邢台/ns
5月7日温州房产网签共409套 成交面积50068.29㎡	温州/ns
南京城北3盘公证摇号均未当日卖完，二手房挂牌价出现较大回调	南京/ns
宁夏公积金重大调整：取消装修提取和住房公积金支付购房首付款	宁夏/ns
2018拆迁年！昆明最新“拆迁地图”正式出炉，这些人要发了	昆明/ns
成都房协会议纪要悄悄流出，房地产再次成为实体经济额“夜壶”？	成都/ns
青岛沿海一线高端房产，之崂山“锦园南区”（喜欢房产的关注下）	崂山/ns,南区/ns,青岛/ns
深圳打工者住“亲嘴楼”的辛酸故事，房东：爱租不租，不租搬走！	深圳/ns
突发！公积金新政发布 又一条炒房路堵死 附昆山公积金买房指南	昆山/ns
荆门市开展房地产市场排查，一批违规开发企业和物业公司责令整改	荆门市/ns
又涨了？！厦门房价全国第4！最新二手房报价出炉，你还买得起哪	厦门/ns
成都：限价太狠，限购太松，全民疯狂炒房后或将一地鸡毛（政策篇	成都/ns
「每日房价」均价4340元/㎡，渭南商品房5月8日网签25套	渭南/ns
链家集团旗下品质加盟品牌“德佑”正式进入青岛 房产服务再升级	青岛/ns,链家集团/nt
深圳房价“十九连降”，房价数据就是一套路！专家：购房者压力大	深圳/ns
晋城5月在售楼盘房价出炉！房源稀缺！刚需购房者又该去哪买房？	晋城/ns
海南房产 ‖ 一夜间“抢”房者被叫停！海南楼市站在了十字路口	海南/ns
不是汉口也不是汉阳，为什么偏偏是武昌中心的二手房这么抢手？！	汉口/ns,武昌/ns,汉阳/ns
武汉刚需看过来：首套公积金最高可贷84万，这些你需Get到！	武汉/ns
「每日成交」5月7日北京新房签约128套，二手房签约947套	北京/ns
房地产不火了？上海夫妇假离婚成真，复婚无望上法庭，如何解释？	上海/ns
南沙不沉的航母！	南沙/ns
核潜艇 中国的不错	中国/ns
罕见：中国武器价格表	中国/ns
中国的隐形轰炸机来了？	中国/ns
最后一批纳粹士兵被遗忘北极	北极/ns
日本能研制出第六代战机吗？	日本/ns
揭秘中国古代九支神秘部队！	中国/ns
音乐响起，像中国军人敬礼！	中国/ns
中国战机新涂装，帅到没朋友	中国/ns
民国风云之细数山西王兵力情况	山西/ns
航母抵达香港，会有什么影响？	香港/ns
中国一款导弹，销售量全球第一	中国/ns
中国研狙击榴弹炮：千米外毙敌	中国/ns
日本为什么不是枪支合法的国家？	日本/ns
4名汶川地震救援官兵的汶川记忆	汶川/ns,汶川/ns
中国第一种超音速战斗机——歼6	中国/ns
中国001航母和辽宁舰哪个强？	中国/ns,辽宁/ns
狼牙山五壮士英勇对抗日本侵略部队	五壮士/ns,狼牙山/ns,日本/ns
中国历代军服复原效果图，开眼界了	中国/ns
烈日与黄沙下的决战：二战北非战役	北非/ns
中国目前使用的手榴弹是哪种型号？	中国/ns
盘点全球最厉害的坦克 中国的上榜	中国/ns
古代中原步兵为何总是对骑兵无解？	中原/ns
苏联1945年前研制的装甲车图集	苏联/ns
为什么日本军人拼刺刀时要卸下子弹？	日本/ns
陆军首个“智慧军营”，河南“造”！	河南/ns
铁血德意志：腓特烈大帝的普鲁士军队	德意志/ns,普鲁士军队/nt
台媒：解放军将在更多南沙岛礁部署战机	南沙/ns
如果原子弹爆炸后日本没投降，会如何？	日本/ns
中国航母开卖后，第一个购买者竟是印度	中国/ns
二战中芬兰为何要加入德国去进攻苏联？	苏联/ns
大国重器，中国远程战略轰炸机呼之欲出	中国/ns
中国最具威慑的导弹 有一种几乎拦不住	中国/ns
军情｜美媒：中国导弹正在改变天空均势	中国/ns
日本“超大和”级战列舰的防御能力如何？	日本/ns
解密中国新型隐身轰炸机 航程超1万公里	中国/ns
中国未来航母想象图，其中这款真是逆天了	中国/ns
广岛核爆炸投放炸弹的飞机是怎么逃离的？	广岛/ns
英国曾想送给中国一艘航母，却因一事耍赖	中国/ns,英国/ns
抗日战争中，北平陷落后日本都做了什么？	北平/ns,日本/ns
19年前的那次轰炸 中国人不会忘却……	中国/ns
卫星照片证实中国开造第6艘055驱逐舰	中国/ns
日本有能力发展大型航母和核动力航母吗？	日本/ns
美菲开启年度联合军演，强调并非针对中国	中国/ns
中国配备神秘炸弹，一天让日本回归石器时代	中国/ns,日本/ns
呵呵哒！越南要求中国撤走南海岛屿上的导弹	中国/ns,南海/ns
比《红海行动》还大扯.潜艇.航母齐上阵！	红海/ns
汶川地震救援老兵追忆过往：没愧对这身军装	汶川/ns,汶川/ns
缅甸最大口径迫击炮，在春节期间竟成了鞭炮	缅甸/ns
空军战机绕飞台岛巡航是怎么绕的？有何意义？	台岛/ns
女生新兵，分配到西藏了，有什么要注意的吗？	西藏/ns
二战期间，日本在世界范围内一共杀了多少人？	日本/ns
中国最强舰队现身，一眼望不到边，十分霸气！	中国/ns
南沙群岛部署导弹 中国：无心侵犯者无需害怕	中国/ns,南沙群岛/ns
中国战斗机首次走出国门参战：将对手打懵了！	中国/ns
外军吐槽中国95式步枪不好用，比不上m16	中国/ns
中国核弹已经足够抗衡美国 全中国人的骄傲！	中国/ns
中国001A航母早就完工，为何至今仍不服役？	中国/ns
中国正逐渐走向双航母时代 有多艘航母才是正常	中国/ns
中国自行研制的利器，曾在反击战中立下汗马功劳	中国/ns
中国第二艘航母首次出海试验 现场高清画面公开	中国/ns
看解放军是怎么套路日本兵的，学好外语很重要啊	日本/ns
土豪国拿235亿来中国 点名就要中国这款武器	中国/ns
疑似中国新一代隐形战斗轰炸机曝光 或是歼17	中国/ns
红海行动装备盘点，网友最好奇的是这一件武器！	红海/ns
这支臭名昭著的部队，被视为日本军国主义的化身	日本/ns
日本测试新式无人机 原型为美军MQ-9“死神”	日本/ns
日本军人在鼻子下留一撮胡子，知道原因后笑掉大牙	日本/ns
中国“科幻步枪”研制成功：比美国大兵的枪酷多了	中国/ns
为什么中国战斗机的机头上都有一根很长的针状物？	中国/ns
大炮军舰时代即将来临？大口径舰炮越来越受欢迎！	即将来临/ns
为豺狼准备的猎枪：中国已在扩建岛礁上部署导弹！	中国/ns
萨达姆在沙漠中数百架战机，其中包括两架中国战机	中国/ns
大消息，歼15舰载机升级版，成中国的“咆哮者”	中国/ns
航空母舰 辽宁舰 UG建模造型 中国梦 强军梦	辽宁/ns
日本不害怕东京大轰炸，为何两颗原子弹就投降了？	日本/ns
全球十大防空导弹盘点：中国只有一款上榜 排第7	中国/ns
数字里的中国首艘国产航母，一目了然！Y国太慢了	中国/ns
中国突然“紧急”集结7000名解放军，发生啥事？	中国/ns
歼20战斗机重大改进，“科幻”装备似中国版钢铁侠	中国/ns
时隔七十年日本再次组建这支部队，实力强劲那又如何	日本/ns
如果日本人看了我们的抗日神剧，他们会有什么感想？	日本/ns
中国还缺一种“空中大力士”：美军55年前就装备了	中国/ns
中航宣传片神秘机型亮相 中国版B-2轰炸机来了？	中国/ns
中国军舰命名如此严格！地级市撤销，军舰也跟着改名	中国/ns
豺狼来了有猎枪：中国已在扩建岛礁上部署防空导弹！	中国/ns
俄媒：中国歼20近期内很难量产，高性能也显得多余	中国/ns
俄罗斯这款设备，中国最想买，能让歼20再进步十年	中国/ns
中国这款隐身高超声速武器在研 其精度惊人收获重大	中国/ns
中国最急缺的一款大飞机即将亮相：一张图片就可以证明	中国/ns
中国大飞机三兄弟曝最新进展 运20进行边界极限试验	中国/ns
运送广岛原子弹的1200美军，战后只活下来300人	广岛/ns
中国首艘国产航母001用的是蒸汽轮机还是燃气轮机？	中国/ns
中国首颗原子弹爆炸后，为什么苏联的反应比日本还大？	苏联/ns,中国/ns,日本/ns
汶川，那些冲在最前面的人：一个军事记者的抗震日记！	汶川/ns
惊现中国冒牌火箭炮！原来是这个山寨国在抢我国的生意	中国/ns
十年前真实影像资料，解放军救援汶川大地震的受伤人员	汶川/ns,汶川/ns
当年投放广岛原子弹的飞机是如何做到不受爆炸影响的？	广岛/ns
中国当年使用的王牌武器，汽油桶火炮为何逐步退役了？	中国/ns
二战时日本有哪些设计比较成功，没有太大槽点的武器？	日本/ns
驾驶辽宁舰庆祝海军成立69周年，舵手居然是个小姑凉	辽宁/ns
这武器是中国卖得最好的一款，35年热销20多个国家	中国/ns
中国两款王牌导弹悄然部署该地 美军得知后：情况不妙	中国/ns
全世界军人唯中国最帅！中国“男神”在莫斯科！帅炸了	中国/ns
中国超高音速武器出现，成为卫星噩梦，直接摧毁炸药库	中国/ns
此国曾是中国领土，海军7个人，女兵丰满壮硕嫁不出去	中国/ns
中国沉默版鸭嘴兽曝光 隐身战轰将成为又一反航母利器	中国/ns
日本人看到中国的抗战剧，尤其是抗日神剧是什么反应？	中国/ns,日本/ns
中国正改进现代级驱逐舰！造船工业已经远远超过俄罗斯	中国/ns
俄罗斯展示新型无人机，自称强于美军！不如买中国的吧	中国/ns
印度海军放狠话：50战舰全天候盯死印度洋上中国军舰	中国/ns,印度海军/nt
日战机拍到中国无人机巡航别着急，更先进无人机还没登场	中国/ns
日本二战时候的伙食有多差？军官骨瘦如柴，士兵饥饿而死	日本/ns
美国咬定中国055系巡洋舰！身兼多职055名称无所谓	中国/ns
哈尔滨 侵华日军731部队铁路专用线、锅炉房和回水池	哈尔滨/ns,731部队/nt
难怪日本不欢迎中国这艘舰艇，舰艇名字就让他们忌讳不已	中国/ns,日本/ns
看看中国战舰如何装填导弹 再看美军驱逐舰 差别太大了	中国/ns
为何只有大国才养得起航母？看完辽宁舰的账单你就知道了	辽宁/ns
中国为何要造小吨位核潜艇？符合当下需要，近海作战无敌	中国/ns
苏联脑洞大开，研究出飞行坦克，坦克会飞就问你怕不怕？	苏联/ns
亚洲最强，两代国产近程舰空导弹，全面部署中国海军军舰	亚洲/ns,中国海军/nt
你好，轰-20！中国下一代轰炸机以最神秘方式“亮相”	中国/ns
中国女子仪仗队高清图，最美最甜军人，正步踢出中国威风	中国/ns,女子仪仗队/nt
狂妄！美军2架轰炸机再“侵入”中国，看中国如何反击！	中国/ns
二战日本最怕的中国狙击手，只要他一出场，全部望风而逃！	中国/ns,日本/ns
抗战战场上中国装甲部队竟然比日军还强，那为什么打不过？	中国/ns
上个世纪的苏联军备狂想：揭秘鱼雷坦克与火箭坦克发展简史	苏联/ns
中国帮助白俄罗斯完善航天军队，白俄罗斯：要好好回报中国	中国/ns,航天军队/nt
海南农民无意发现宝贝，美国各城市展出，加速二战日本战败	海南/ns,日本/ns
中国军工呈现井喷状遭妒忌，日本寻求自我安慰说出这样的话	中国/ns,日本/ns
中国古代有一种士兵比现代美军还厉害，你知道他们是谁吗？	中国/ns
中国对越反击战，这些高干子弟冲锋陷阵在第一线，血洒南疆	中国/ns,南疆/ns
中国歼10战机遭遇滑铁卢，巴铁道出真相，令人国人深思！	中国/ns
这个小国太给力！促进中国进步20年，还无偿赠送现金武器	中国/ns
一炮轰穿！中国新式火箭筒发射时红如熔岩，装甲车也扛不住	中国/ns
中国蒸汽轮机舰队可组成完整航母编队，却为何从未出现过？	中国/ns
狙击手大赛上，中国狙击手伪装起来，各国士兵找半天没找到	中国/ns
中国首支数字化部队应运而生，这是现代战场发展的必然趋势	中国/ns,首支数字化部队/nt
一日本女兵逃亡到中国，后学汉语，在中国结婚生子，深爱中国	中国/ns,日本/ns
四位军事奇才：凯撒第四，拿破仑排第三，冠军是中国一代帝王	中国/ns
中国航天员为什么都是军人，而不是博士、科学家等科研人员？	中国/ns
汶川地震10周年：那些80后证明他们可将“军魂”发扬光大	汶川/ns,汶川/ns
这款“潜艇克星”船中国也有了！不带任何武器就能抓住核潜艇	中国/ns
美国如果不用原子弹，日本照样会投降，为什么还非用不可呢？	日本/ns
两个核大国10架战机3艘军舰同时抵近秀肌肉！日本该醒醒了	日本/ns
美国二战时为什么对日本动用核武器，而不对德国使用核武器？	日本/ns
日军侵华时，为何军队阵容每次都比中国大？做法让人不敢想象	中国/ns
《红海行动》中国女兵太帅了，扛起毒刺导弹干掉了敌军直升机	中国/ns,红海/ns
为了南海开发！中国将建造这种堪比“核动力航母”的大型船舶	中国/ns,南海/ns
谁该颤抖？中国造激光炮弹竟能直接用到北约火炮，效果还更好	中国/ns
中国核弹数量为什么至今都是个谜？真实原因让各国竖起大拇指	中国/ns
隐蔽性太差！中国火箭筒发射如同火山喷发！他花十元就能搞定	中国/ns
日本妄想碾压歼20，求美国帮忙研发新战机，解放军：随便造	日本/ns
中国第6艘055确认开工，造舰规模空前，主力打造一流海军	中国/ns
主动送大礼！美军核心技术献日本，专家：日本不要高兴的太早	日本/ns
二战后，日本老兵拒绝道歉，甚至扬言：如果开战，还想去打仗	日本/ns
导弹进驻南海后，美驻菲大使：要继续巡航南海，保护菲律宾！	南海/ns
一北约强国决定投入中国怀抱：港口卖给中国，军工技术随便看	中国/ns
中国花一亿都买不了的武器，如今成废铁，仅500万就处理了	中国/ns
美军曝光中国10万吨级新型核航母，捕风捉影还是确有其事？	中国/ns
中东之虎影子部队所向无敌，美军都听指挥，这次以色列麻烦大了	中东/ns,虎影子部队/nt
中国舰艇表面起褶子，美国也没招，外军这法子真是让人大开眼界	中国/ns
中国炮兵完成一次任务仅仅只需要5分钟，打完就跑，绝不停留！	中国/ns
二战中叛变的苏联女兵，成德军刽子手，工作完后与德国军官厮混	成德军/nr,苏联/ns
十年前16万中国军人成建制冲向这里，只为了和死神多抢一秒钟	中国/ns
中国这项黑科技比航母重要100倍，美专家感叹中国瞒过所有人	中国/ns
同样都是武器，俄罗斯这款被夸上天了，中国这款却远远被低估了	中国/ns
俄罗斯向印尼低头进口武器，这到底怎么回事？实力不能再小看了	印尼/ns
中国军舰加长4米，日本媒体：苍龙潜艇跟踪辽宁号航母已成历史	日本/ns,中国/ns,辽宁/ns
强势警告！辽宁舰队进入“一级备战”状态，“拦路虎”转身就溜	辽宁/ns
一组图告诉外媒中国军人救灾为何不带枪！看到这些还有疑问吗？	中国/ns,中国/ns
了解一下中国军工制造水平，96%以上的船型中国船厂都能建造	中国/ns
7天的时间，他击落了6架日军战机，成为中国第一位王牌飞行员	中国/ns
上万台报废的战斗机发动机如何处理？美国直接销毁，中俄最实用	中俄/ns
美战机刚刚接近中国领空就火速返航，后来发现其实已经报废了！	中国/ns
中国支援俄军这一武器，一举扭转叙利亚失衡局势！特朗普：不服	中国/ns
中国单兵火力达到什么程度？连轻重机枪都看不上，直接上大家伙	中国/ns
国之利器！中国这一压箱底神器海试，威力十分强悍，外媒哗然！	中国/ns
震撼！看了才知道国产航母的造价，全世界仅有中美两国负担的起	两国/ns
近代中国最大的兵工厂，生产力惊人，储备子弹数量远超欧美等国	中国/ns
中国最硬气城市，禁止日本人踏入半步，除非对侵华历史低头认错	中国/ns,日本/ns
中国战舰南海开火 导弹呼啸扑向目标 16个鹰击-18有点少	中国/ns,南海/ns
小鬼子打到家门口，中央军用四门榴弹炮为川军助威，炮轰日军！	四门/ns
中国的炮弹技术绝了，不仅能够防空还可以反导，说出来你都不信	中国/ns
苏联打造世界上最大的核潜艇，因造价成为一种负担，只能选择改造	苏联/ns
辽宁舰的最后一道防线火力第一，点射9秒就要花掉150万人民币	辽宁/ns
最受青睐的四把武器：第一把使用最多，最后一把中国军迷的首选！	中国/ns
中国歼8战斗机有新出路，或可学米格31带高超音速导弹一击必杀	中国/ns
韩国客机酷似侦察机被苏联击落，269人遇难，差点引起美苏大战	苏联/ns
侵华战争的日本兵餐餐吃肉，不从日本运来，往往都是“就地取材”	日本/ns
珍贵二战影像，二战时美军“科罗拉多”号战列舰穿越巴拿马运河！	巴拿马运河/ns
被忽悠了！辽宁舰并非训练舰，一画面透露出中国航母的真实战斗力	中国/ns,辽宁/ns
8万吨巨舰失去控制，海面上横冲直撞，该国船员为救中国航母牺牲	中国/ns
一小时打遍全球，传中国海、陆、空基高超音速武器均获重大突破！	中国海/ns
汶川地震中两架次救走230人的飞机 事后中国花费3亿购买4架	中国/ns,汶川/ns,中国/ns,汶川/ns
中国又一款神秘武器亮相，火力可覆盖第二岛链，堪称航母杀手锏！	中国/ns
印度总爱与中国比拼研发，但是这款大飞机上天后，只能找日本买了	中国/ns,日本/ns
二战第一飞行员，单人击落352架敌机，战后在苏联挖了10年煤	苏联/ns
全球只有中国能制定这一领域的国际标准，但无意中帮了美军的大忙	中国/ns
中国国产空天轰炸机研制成功，美专家：可怕的武器不止美国才有了	中国/ns
辽宁舰已经三十岁了还能再服役多久？真实情况让美大呼自己被骗了	辽宁/ns
央视曝光中国版“萨德”导弹试射一幕！美专家：美国反导技术凉了	中国/ns
战争后，这位日本女兵说：要嫁只嫁中国男人，拒绝日本所给的好处	中国/ns,日本/ns
全世界各国对特种兵都有哪些硬要条件？看后才知道中国不是最苛刻	中国/ns
中国魔铲解放军工兵铲 撒贝宁：你就告诉我这个工兵铲不能干什么	中国/ns
为什么只有中国能保存人类仅存30枚氢弹？这位科学家功不可没！	中国/ns
八路军冀中军区警备旅，旅长王长江为何在建国后仅被授予大校军衔	冀中/ns,长江/ns
来中国更早的明斯克号航母，为何遭到中国海军嫌弃？这下必须明白	中国/ns,中国海军/nt
中国空天战机时速高达3万公里，节能环保且成本低，军迷兴奋不已	中国/ns
美国“退群”引发中东震荡！沙特放狠话：伊朗若搞核武器沙特也搞	中东/ns
这款高教机为中国斩获无数订单，我海空军抢着要，极有可能上航母	中国/ns,海空军/nt
若是美国放开对日本的限制，日本真能快速造出航母来？大家想多了	日本/ns
世界上第一个没有军队的国家，靠着和中国搞贸易，小日子过得挺美	中国/ns
美媒：战机飞越解放军基地 飞行员受伤，美提一要求又被中国拒绝	中国/ns
中国防空导弹又一次亮相，各种弥补漏洞型号，一应俱全，不惧威胁	中国/ns
刚刚！美2架战机“擅闯”中国，五角大楼：飞行员眼睛“致盲”!	中国/ns
中东局势再度白热化！北约舰队深入黑海！俄罗斯将使用核武器吗？	中东/ns
喜讯传来！中国重量级军机出现新版本，歼20战机作战半径翻倍！	中国/ns
中国“三航母”时代来临：第三艘航母正式动工，两万名员工已就位	中国/ns
实拍：中国第一艘真正意义上的国产新航母——001A型航空母舰	中国/ns
一群黑影“闯入”海南岛水域，个个大如鲸鱼！体内还有72枚核弹	海南岛/ns
九旬抗战老兵失明73年，去世前只想再摸摸中国的坦克，感人泪下	中国/ns
中国第2款隐身战机生产线大尺度公开，另一款神秘机型也意外曝光	中国/ns
俄核潜艇出租给印度，却从来不让中国参观，如今要卖12艘给我国	中国/ns
局座：苏联核潜艇45节，鱼雷都追不上，世界最快军舰也就35节	苏联/ns
如何评价方先觉将军，他在衡阳保卫战中的选择究竟是正确还是错误？	衡阳/ns
世界最强军，被中国一座城市挡了40年，动用半个世界的力量才攻破	中国/ns
闪击苏联：纳粹德军400万精锐全线猛扑，斯大林坚持不信真会进攻	苏联/ns
1945年日本送给美国一支美女军队，欲缓和美日关系，但结果呢？	日本/ns
46吨的飞机玩格斗？苏联人脑洞太大，还拿破飞机坑中国，都是摆设	苏联/ns,中国/ns
这个日本士兵，偷偷给了中国士兵10万子弹，随后留下遗书举枪自杀	中国/ns,日本/ns
MF+航空｜欧洲5代战机或借鉴中国歼20设计 但前景并不被看好	中国/ns,欧洲/ns
中国一夜间多出10艘“航母”，百架战机待命，美两艘航母紧急改道	中国/ns
渤海造船厂“热闹非凡”，096或已交付海军，否则不会发布这照片	渤海/ns
二战日本女兵太狠！亲手杀死298名婴儿，只为给打仗的“英雄”吃	日本/ns
喜讯连连！解放军又一个歼16战机旅出来了，这次被部署在四川腹地	四川/ns
日本老兵为何不为侵华道歉？91岁老兵说：若再次开战，我还打中国	中国/ns,日本/ns
以军空袭惹恼俄罗斯 卫星侦察驻敘俄军新动向 以总理急忙出访俄国	俄国/ns
中国斗鱼养殖基地	中国/ns
巴马香猪养殖场场地选择	巴马/ns
朔城区联社助力春耕备耕	朔城区/ns
莱西市首家青创农场成立	莱西市/ns
在汉中如何养殖小龙虾？	汉中/ns
河北柏乡春灌用上互联网	河北/ns
中国农机在越南有很大市场	中国/ns
中国农药产品如何在美国登记	中国/ns
安徽开展贫困地区农产品展销会	安徽/ns
闵行区农机驾驶员培训圆满结束	闵行区/ns
绥化“插秧专列”开往三江平原	绥化/ns
揭开中国农民种地不赚钱之迷！	中国/ns
庵上湖有机蔬菜，农药检测无残留	上湖/ns
福建这5类农机可以申请报废补贴	福建/ns
在河北最先进小麦播种机是哪个？	河北/ns
山东郯城：“智能养鸡”助农脱贫	山东/ns,郯城/ns
青海省9.1亿元支农资金保春耕	青海省/ns
蚕老麦黄豆浆流，我在绵阳插秧子	绵阳/ns
朔城区联社助力春耕备耕热火朝天	朔城区/ns
怎样寻找河南温县的山药种植户？	河南/ns,温县/ns
费县‘清香’核桃嫁接育苗技术研究	费县/ns
莱芜市召开农药减量增效技术培训班	莱芜市/ns
山西支持农机社会化服务项目见实效	山西/ns
惠州市加快推进农产品溯源平台建设	惠州市/ns
吉林梨树陆久和牛养殖有限公司扫描	吉林/ns
河北省主要农作物良种覆盖率逾98%	河北省/ns
休渔了 养殖海鲜成江苏徐州市场主角	江苏/ns,徐州/ns
2018安徽新型肥料暨农业械博览会	安徽/ns
广西新增9个获地理标志保护的农产品	广西/ns
漠河县农机总站 为春耕生产保驾护航	漠河县/ns,农机总站/nt
突发惨剧｜海南养殖户不堪重负自杀身亡	海南/ns
深圳环境最好的农家乐，知道就算你牛！	深圳/ns
四川小麦主要的病虫害，应该怎么防治？	四川/ns
四子王旗公安局为春耕备耕生产保驾护航	四子王旗/ns
日照市进一步优化完善农机购置补贴政策	日照市/ns
鸭绿河巧改“运苗机”助力插秧节本增效	鸭绿河/ns
秀山：用“生物导弹”取代农药防治二化螟	秀山/ns
新疆伊宁市水产养殖面积已达4000余亩	伊宁市/ns,新疆/ns
浦东深入农药生产企业 源头管控农药产品	浦东/ns
江西安福县：乡政府大院建起“扶贫电站”	安福县/ns,江西/ns
点赞！淄博市这25个农产品品牌全省知名	淄博市/ns
郯城：用好养殖“生物链”每亩水蛭省三千	郯城/ns
平昌县农产品质量安全抽检合格率达100%	平昌县/ns
河北省农房保险参保农户达到779.71万	河北省/ns
黑龙江对农户更换生物质炉具给予70%补助	黑龙江/ns
武当山脚下的这个乡镇开展了养蜂扶贫培训！	武当山/ns
震后产业结构调整让佳山果农念起“致富经”	佳山/ns
麻栗坡县2018年玉米新品种试验播种结束	麻栗坡县/ns
广西力争建成10个国家级特色农产品优势区	广西/ns
大冶市创建省级农产品质量安全市系列报道七	大冶市/ns
麻栗坡县三举措做好农产品质量安全监测工作	麻栗坡县/ns
惠州农药生产废水有哪些特点，又该如何处理	惠州/ns
山东各地抓住小麦孕穗期关键时期防控病虫害	山东/ns
随着环保的压力，中国农村养猪还能走多久？	中国/ns
控、替、精、统！陕西：重点施策力推农药减量	陕西/ns
河南部署“三夏”生产 全力夺取夏粮丰产丰收	河南/ns
土默特左旗察素齐镇司法所“送法下乡”助春耕	土默特左旗/ns,察素齐镇司法所/nt
效果拔群！广东甘蔗地利用植保无人机喷洒农药	广东/ns
沭阳县多管齐下抓好农药使用量“零增长”行动	沭阳县/ns
陕西榆林一大波特色农产品将登上央视农业频道	陕西/ns,榆林/ns
广西：力争建成10个国家级特色农产品优势区	广西/ns
永兴荔枝蜜上市 贫困户微互助打开农产品网路	永兴/ns
山东农业突出绿色发展理念 促进耕地质量改善	山东/ns
三江集团原牧求娱APP打造手机“开心农场”	三江/ns
盱眙小龙虾养殖基地：500多斤赚五、六千元	盱眙/ns
黑龙江猪价上调，摆在养猪人面前的是生，还是？	黑龙江/ns
齐齐哈尔市多环节促进养殖增产农民增收产业发展	齐齐哈尔市/ns
2018年4月份武汉白沙洲市场水产品价格简析	武汉/ns
今后，身边的全时超市也能买到北京优质农产品了！	北京/ns
永城民生：农民朋友注意！永城农机补贴开始办理喽	永城/ns
新疆阿克苏沙雅县脱贫项目促产业 规模养殖助脱贫	新疆/ns,沙雅县/ns
这位老人一辈子没出过大山，靠养牛解闷，很可怜的	大山/ns
养殖黄鳝是大塘网箱养还是制水泥池养，哪个好呀？	大塘/ns
新希望、大北农、阿里进军西北养猪，原因大揭秘！	西北/ns,阿里/nt
渭源：670万元农机补贴让农民分享农机化“红利”	渭源/ns
渭南影像之渭南人割麦，这样的场景现在真的不多见了	渭南/ns
湖北宜昌：乡村，农民挑粪，用农家肥种植蔬菜！赞！	湖北/ns,宜昌/ns
庆阳市药品稽查局驻村工作队外出学习精准扶贫好经验	庆阳市/ns,药品稽查局/nt
漳浦县下辖6个国有农场 完成登记发证13.7万亩	漳浦县/ns
重庆80后女大学生村官：让村民致富 我有“想法”	重庆/ns
厉害！1人养4万只鸡！快来看蒙阴的高科技养鸡场！	蒙阴/ns
兰坪举办农机专业合作社骨干社员暨农机操作手培训班	兰坪/ns,农机专业合作社/nt
凉州区第二季度农产品质量安全例行监测抽样圆满完成	凉州区/ns
种地也要跟潮流！4种“新型武器”亮相巴中田间地头	巴中/ns
一字千金 邹城市全球重金征集农产品区域品牌创意名称	邹城市/ns
水稻机插秧同步侧深施肥技术集中示范活动在建三江举办	建三江/ns
安徽繁昌：担心农户投资被骗 发改委紧急叫停光伏项目	繁昌/ns,安徽/ns
四川省加强农产品品牌建设 将产业优势转换为品牌优势	四川省/ns
企业不挣钱 农民觉得贵 中国农机问题到底出在哪里？	中国/ns
高端化、国际范！今天开幕的新疆农机博览会“亚克西”	新疆/ns
陕西农村广播发起“金果行动” 帮受灾果农家门口找工作	陕西/ns
南宁一批乡镇喜获“十佳乡镇”殊荣，你的家乡获奖了吗？	南宁/ns
镇江市质监局开展春耕农资定量包装商品计量专项监督抽查	镇江市/ns
借市场让农户用上清洁能源 荆州清洁能源入户率达83%	荆州/ns
「今年鞍山市将发放耕地地力」保护补贴资金2.6亿多元	鞍山市/ns
华阴市农机管理站开展农机购置补贴辅助管理系统电脑培训	华阴市/ns
周末不知道该去哪儿玩？太原有这么多农家乐园你知道吗？	太原/ns
河南三家养猪上市公司累计融资超410亿 猪价下跌三成	河南/ns
山东郯城：“智能养鸡”助农脱贫 全封闭式、智能化控制	山东/ns,郯城/ns
华南养殖户已盯上抗病强、耗氧少，养殖密度超高的巴沙鱼	华南/ns
绝对不是火拼！为何新希望、大北农、阿里都热衷西北养猪	西北/ns,阿里/nt
「纪念中国品牌日」聊城农产品：走出一条品牌农业强市之路	中国/ns,聊城/ns
泰安大葱开始上市，净葱上车价4毛，菜农翘首以盼客商到来	泰安/ns
俄罗斯5万人，“强烈反对”当中国农民，想种地根本没门！	中国/ns
辽宁省供销系统“升级”主渠道 推进农产品流通体系现代化	辽宁省/ns
山东水发田园综合体：提升农产品竞争力，带领农民共同致富	山东/ns
中国生态文明建设（中英对照）连载之三十六：耕地保护制度	中国/ns
连城县农业局举办2018年农产品质量安全监管工作培训班	连城县/ns
天津市和平区市场监管局抽检6批次食用农产品样品 全部合格	天津市/ns,和平区市场监管局/nt
山西屯留县开展农业生产托管服务 探索解决“谁来种地”问题	屯留县/ns,山西/ns
巴铁果农诉苦：我们的水果年年滞销，中国：别担心，我来进口	中国/ns
公司+合作社+贫困户 山东郯城“全自动智能养鸡”特色扶贫	山东/ns,郯城/ns
靖江水稻育秧工作已经启动，可供应5000多亩地的大田插秧！	靖江/ns
好消息！养猪人，中国加强对美进口猪肉查验，进口猪肉或再减少	中国/ns
耕地若不补，建设用地就不批！山东永久基本农田保护有了硬杠杠	山东/ns
被玩坏的猪价，河南猪价连跌30%，但这些养猪公司赚了几百亿	河南/ns
河南菜农蒜苔收获后随处丢弃，网友：你们卖不掉，我们吃不起！	河南/ns
官方公布：云南这8个贫困乡镇实现脱贫，来看看有你的家乡吗？	云南/ns
温州富商竟抛下过亿产业包地养鸡，首创“共享母鸡”征服10万人	温州/ns
山东严守耕地红线 耕地保有量到2020年不少于11288万亩	山东/ns
群英荟萃，齐聚一堂丨2018国际养猪繁殖研讨会在长沙闪耀开幕	长沙/ns
韶关这2处高山梯田，春耕来了便美成摄影界网红，随手一拍是大片	韶关/ns
亏3000万元？养殖成本6元，3元/斤补助，贵州晴隆光照库区	贵州/ns
内蒙的特色农产品有哪些你知道么？下面列举的这些你吃过几个呢？	内蒙/ns
湖南小伙80万建起800多平农家乐，前有院后有河，生活乐无边	湖南/ns
东北大豆补贴力度增加：一亩补350元！农户改种、扩种大豆意愿强	东北/ns
抓一把黄豆埋进花盆里，绿萝吊兰呼呼长疯了，叶绿杆粗10年不施肥	花盆里/ns
全国唯一没有农民没有乡镇！城市化率100％的城市，远超上海北京	上海/ns,北京/ns
确认过眼神 “精准扶贫”遇上对的人——河北省驻村第一书记扶贫进行时	河北省/ns
黑龙江省种子管理条例公开征求意见 禁止非法生产经营转基因农作物种子	黑龙江省/ns
实拍 休渔期的青岛早市 海鲜琳琅满目 养殖大虾38一斤 鲅鱼28一斤	青岛/ns
云田诗词：山水洗心	云田/ns
学学中国诗词有多好	中国/ns
第十四届深圳文博会	深圳/ns
深圳文博会主要交易什么？	深圳/ns
株洲首家数字书法室开课啦	株洲/ns
上联：长安一片月：求下联	长安/ns
上联：千山桃花笑；求下联	千山/ns
云南有三幅对联名扬海内外	云南/ns
上联：贵州粥贵。下联如何对？	贵州/ns
首届吉林省艺术节6月6日启动	吉林省/ns
谁能够代表当今中国的诗词水准？	中国/ns
上联：黄河天上水，下联怎么对？	黄河/ns
上联：桃园三结义，如何对下联？	桃园/ns
上联：千山春风笑，如何对下联？	千山/ns
上联：夜醉长沙酒，如何对下联？	长沙/ns
蓬溪县中小学书法特色教育出实招	蓬溪县/ns
上联：良书惠播九州，下联如何对？	九州/ns
诗词中的除夕，带你领略千古中国年	中国/ns
鸡西政协书画院甲骨文书法在沪展出	鸡西/ns,政协书画院/nt
广东省书法评论家协会 提名展开幕	广东省/ns
上联：山山出竹竹成林，如何对下联？	山山/ns
上联，月色淡淡映千山，如何对下联？	千山/ns
上联：长沙沙水水无沙，下联怎么对？	长沙/ns
上联:桃园十里轻风舞，怎么对下联？	桃园/ns
上联：横山雨雪土里埋，如何对下联？	横山/ns
上联：海上游客游上海，下联怎么对？	上海/ns
「华风原创诗词」汶川地震十周年有记	汶川/ns,汶川/ns
上联：斜阳古道烟村暮，如何对下联？	烟村/ns
上联：青海青年游青岛，如何对下联？	青海/ns,青岛/ns
上联：鹰跃鹰潭鹰留影，怎么对下联？	鹰潭/ns
上联：北京北，南京南，如何对下联？	南京/ns,北京/ns
上联：汉中桃李冠天下，如何对下联？	汉中/ns
上联：雪落北国一片白，如何对下联？	北国/ns
上联：孤舟划碎江中月，下联怎么对？	江中/ns
上联：重阳重庆重相逢，下联怎么对？	重庆/ns
中国传统的诗词古训用英语如何翻译？	中国/ns
上联：清源山中鸟鸣喧，下联如何对？	清源山/ns
上联：去过成都，都成过去。求下联？	成都/ns
下联：二月春风醉长安，如何对上联？	长安/ns
对联：春风几度杏花村，该如何对对联？	杏花村/ns
中国当代艺术界名人雷鸣书法摄影作品展	中国/ns
厉害了！原来他在日本被奉为书法的宗师	日本/ns
第十四届深圳文博会，梅州馆展现独特魅力	深圳/ns,梅州馆/nt
临沂红旗小学首届文化艺术节书画展进行时	临沂/ns,红旗小学/nt
中国历史上有哪些诗词句子让人过目不忘？	中国/ns
首届“华山杯”全国榜书书法大展获奖作品	华山/ns
上联：东风送暖千山绿丨下联：请君赐教美对	千山/ns
52件元代黑陶车马俑亮相深圳文博会分会场	深圳/ns
一位德国艺术史学家是如何解读中国书法的？	中国/ns
内蒙产的玉石这么漂亮啊，内蒙玉石老师收藏	内蒙/ns
上联：湖南到湖北，走南闯北，下联怎么对？	湖南/ns,湖北/ns
上联：蜻蜓点水弹奏平湖秋月，下联怎么对？	平湖/ns
治多县文化馆举办全国第二届藏文书法日活动	治多县/ns
上联：临溪抚琴玉指飞弦流古韵，如何对下联？	临溪/ns
家里有书法少年？珠中江青少年书法大赛了解一下	珠中江/ns
#百城对春联#上联:西湖断桥白娘子，求下联？	西湖/ns
泰山石在众多奇石中独一无二的收藏价值是什么？	泰山/ns
兰州交警“大比武”	兰州/ns
成都美团打车的未来？	成都/ns,美团/nt
江源交警进驾校话安全	江源/ns
印江公安交警开展酒驾整治	印江/ns
唐山市怎么考取摩托车驾照？	唐山市/ns
黟县：驾驶报废车 被民警查获	黟县/ns
「三反一查」华池酒驾曝光（十）	华池/ns
宝坻交警查扣一大波违法上路农用车	宝坻/ns
镇原交警孟坝中队查处4起无证驾驶	镇原/ns
畅行中国 交警同行——五一全纪实	中国/ns
荆门交警“失驾”整治行动今日开展！	荆门/ns
景县交警持续开展“渣土车”整治行动	景县/ns
丰田锐志，来自邻国日本的驾驶新体验	日本/ns
70%无锡滴滴外卖小哥选择回归美团	无锡/ns,美团/nt
庆阳机场公安交警持续开展酒驾宣传活动	庆阳/ns
河津：心存侥幸用假证 交警识破受处罚	河津/ns
黄龙县交警全力打好道路交通安全攻坚战	黄龙县/ns
滴滴外卖南京开战 骑手打着高铁来报名	南京/ns
河北改装S320驾驶辅助行人识别测试	河北/ns
沁源交警大队：坚持整治酒驾“零容忍”	沁源/ns
三柳高速融安到柳州可以驾驶摩托车吗？	融安/ns,柳州/ns
「畅行中国 交警同行」安全带=生命带	中国/ns
聊城的朋友，你考c1驾照花了多少钱？	聊城/ns
肥城交警利用监控系统查获严重违法车辆	肥城/ns
考到驾驶证后，不敢开车上路的是哪些人？	上路/ns
山丹县截止5月2日驾驶证满分未学习公告	山丹县/ns
中卫交警的这位小姐姐，你被“偷拍”了！	中卫/ns
北京车展新科技 集中探索自动驾驶商业化	北京/ns
拿到驾驶证后，不敢开车上路的是什么人？	上路/ns
刚拿到驾驶证的你上路有哪些无脑的神操作？	上路/ns
「夏季严打」龙里交警全面出击打击违停车辆	龙里/ns
裕华区第一人，真牛！（附驾驶证换证流程）	裕华区/ns
陇西高速交警加大辖区施工路段检查管控力度	陇西/ns
核载8人竟载了15人被长春交警抓了个正着	长春/ns
江西：最有钱的8个人，滴滴出行创始人上榜	江西/ns
酒驾惹祸！凌晨3点济宁一轿车“飞上”限高杆	济宁/ns
起底滴滴顺风车：上车前司机就知道你美不美了	美不美/ns
衡东交警“双管齐下” 严整学生无证驾驶之风	衡东/ns
「三反一查」临洮交警曝光第七批违法超速车辆	临洮/ns
滴滴司机非法营运被抓，竟从天桥一跃而下……	天桥/ns
横山交警查处严重交通违法行为通报第四十八期	横山/ns
德安交警坚守“四阵地”全面开展交通安全宣传	德安/ns
临漳交警利用农村大喇叭开展交通安全教育活动	临漳/ns
山丹县截止5月2日驾驶证逾期未审验信息公告	山丹县/ns
临汾市交警支队公告19处道路交通违法抓拍点	临汾市/ns,交警支队/nt
山丹县截止5月2日驾驶证逾期未换证信息公告	山丹县/ns
昨天眉山岷江一桥桥头一位摩托大哥酒驾遭惨了	眉山/ns
自动驾驶汽车的中国“慧眼”—Maxieye	中国/ns
从北京车展奇瑞展台，看未来智能驾驶三大趋势	北京/ns
收费疑云｜柳州网约车司机投诉：被乱收六百元	柳州/ns
中国最牛的机动车驾照是A1、A2和E证吗？	中国/ns
七眼神器助力临沂交警执法 全天候零死角记录	临沂/ns
山西高速交警开始现场处罚“乘车人不系安全带”	山西/ns
沁源县交警大队联合路政部门 开展治超宣传活动	沁源县/ns,交警大队/nt
潼关交警深入辖区矿场 再掀企业交安宣传新浪潮	潼关/ns
护航｜淄博交警开展“净化五号”大规模统一行动	淄博/ns
从北京车展奇瑞展台，看未来智能驾驶的三大趋势	北京/ns
「三反一查」华池公安交警持续开展酒驾宣传活动	华池/ns
「聚焦」佛冈交警开展夜查行动查获两起酒驾行为	佛冈/ns
滴滴顺风车、内蒙跨境抓捕等事件大爆发的背后原因	内蒙/ns
济宁：酒后不开车叫滴滴打车 谁知滴滴司机也酒驾	济宁/ns
临汾交警支队重要公告 ! 这19处监控开始抓拍	临汾/ns,交警支队/nt
首汽约车与济钢集团达成合作 瞄准济南网约车市场	济南/ns
从北京车展奇瑞展台，看未来智能驾驶的三大趋势！	北京/ns
预警 和平一校车上路没关门？交警约谈学校负责人	上路/ns
加拿大将安大略省温莎及伦敦纳入到自动驾驶项目中	安大略省/ns
酒后不开车，开车不喝酒，达州一教练酒后驾驶被抓	达州/ns
临沂：非法网约车删除软件也得认罚 最高可罚3万	临沂/ns
冀南新区交警携手农村劝导站开展交通安全宣传活动	冀南/ns
最新消息！儋州驾驶证科目一、科目四可以预约考试了	儋州/ns
临汾交警支队成为全国试点单位，机动车登记更加便捷	临汾/ns,交警支队/nt
首汽约车牵手济钢集团 携手打造济南金牌网约车服务	济南/ns
济南人民被堵在路上的3万个小时，和滴滴的智慧交通	济南/ns
莆田城厢：你就是长了“翅膀” 也飞不出交警的手掌	莆田/ns
马鞍山车主请注意！已有交警在严查这种号牌和标贴！	马鞍山/ns
「三反一查」华池公安交警持续开展拒绝酒驾宣传活动	华池/ns
盘州：交警点名外卖公司 给摩托车违法行为打预防针	盘州/ns
嘀嗒出行登陆济南，补贴频频，能否再掀网约车大战？	济南/ns
厉害！潮汕惊现70岁高龄驾照学员，考科二一次过！	潮汕/ns
没考驾照的聊城人狂欢吧！国家一锤定音：马上执行！	聊城/ns
「曝光」湖州高速交警严查低速行驶，曝光名单出炉……	湖州/ns
六盘水：1400余辆车被查 涉牌涉证2起 酒驾3起	六盘水/ns
为什么日本没人敢酒驾，看完处罚就知道，简直太狠了！	日本/ns
「夏季严打」龙里交警风雨无阻 查处7起酒驾违法行为	龙里/ns
凉州公安交警曝光一批非法拉运务工人员违法车辆（二）	凉州/ns
河南交警发布“黑名单”，80辆车“倒行逆驶”被曝光	河南/ns
夏安 宁南交警联合县运管所持续开展非法营运整治行动	宁南/ns
遂川交警全面开展二、三轮摩托车整治，请带好您的头盔	遂川/ns
2018湖南汽车展览会重磅开幕，滴滴8.5折优惠！	湖南/ns,汽车展览会/nt
鹤壁68岁老人驾照考试“一次过”：年轻人要多学多练	鹤壁/ns
安康岚皋交警：严把源头管理关 加强安全隐患排查治理	岚皋/ns
沿河交警开展货车摩托车集中整治查处交通违法75余起	沿河/ns
济南人注意：快看！济南无酒驾街区来了，你准备好了么	济南/ns
拿了三四年驾照还不敢上路？学会这些轻松驾驶不慌张！	上路/ns
深圳车友收了一辆尚酷2.0T，强化改装后驾驶乐趣无穷	深圳/ns
黄冈人，酒后这3种行为不开车也算酒驾，赶紧告诉家人！	黄冈/ns
青岛交警严查乱停车清理“僵尸车”倡议共创安全有序环境	青岛/ns
郑州，郑州打网约车，打到的美女司机，我要不要做点什么	郑州/ns
贵州高速交警：4S店导购员无证驾车，竟还是个未成年人	贵州/ns
刚刚，郑州运管部门约谈滴滴！顺风车今起全国下线整改！	郑州/ns
刚拿驾照，开车上路的朋友有福了！交通标志大全奉上！！	上路/ns
南丰交警发布连续3次未年检摩托车强制注销的公告（九）	南丰/ns
临汾交警新增19个“违法抓拍”点，有你经常经过的么？	临汾/ns
英媒关注中国机器人港口：用自动驾驶卡车车队搬运集装箱	中国/ns
北京顺义机场招人啦！机长、空姐薪酬福利大曝光，看完我愣住了！	北京/ns
等发工资了，一定要买这12款中国造车载用品，安全又上档次	中国/ns
2018年泗洪县公开招聘事业单位工作人员资格复审公告	泗洪县/ns
第七届中国国际养老服务业博览会在京开幕	中国/ns
甘肃一快递公司拖欠600多万元代收货款遭商户围堵	甘肃/ns
广西银行招聘面试：你学的专业和银行不匹配，为什么来银行？	广西/ns
广州7千工资和深圳1.5w工资该选哪个好？	广州/ns,深圳/ns
海岛版以房养老 实施4年备受欢迎	海岛/ns
湖北农商行的薪酬福利待遇好吗？	湖北/ns,农商行/nt
经纪人：若表现不好，图雷愿意退还新东家一半工资	新东家/ns
临沂临港这家企业招聘200多人，待遇很诱人！找工作的看过来	临沂/ns
缅甸公务员工资够买房吗？	缅甸/ns
南宁原来基本工资是1400，现在涨到1680，是在原来工资的基础上涨280吗？	南宁/ns
宁夏有哪里适合养老？	宁夏/ns
日本农户拖欠29名中国技能实习生加班费 约合人民币68万元	中国/ns,日本/ns
世界上工资最低的总统：年薪不足两万人民币，却要送中国一块地	中国/ns
她们拿着千元工资，却被称为菲律宾民族英雄，非常向往来中国工作	中国/ns
在乌鲁木齐，工资6000是怎么样的体验？	乌鲁木齐/ns
郑州银行社会招聘人员若干名，等你来报 时间至8.10	郑州/ns
中国农村教师为什么不发十三个月的工资？	中国/ns
《首都经济报道》中国国际养老服务业博览会举办 高科技设备助推智慧养老	中国/ns
「好机会不等人」抚顺市第四医院公开招聘23名高层次人才	抚顺市/ns,第四医院/nt
「招聘」洛浦县面向社会招聘公安协警的公告	洛浦县/ns
2018滁州定远县总医院招聘工作人员拟聘用人员公示	滁州/ns,定远县总医院/nt
2018阜阳颍上县润河镇招聘就业和社会保障服务人员16人公告	润河镇/ns,阜阳/ns,颍上县/ns
2018广西桂平市乡镇医疗卫生机构招聘公告（25名）	广西/ns,桂平市/ns
2018合肥市瑶海区档案局招聘政府购买岗位体检通知	合肥市/ns,瑶海区档案局/nt
2018江西樟树市企业招才引智招聘1000人公告	樟树市/ns,江西/ns
2018马鞍山含山县公安局招聘辅警10人公告	马鞍山/ns,含山县公安局/nt
2018年度武汉市事业单位公开招聘集中面试公告	武汉市/ns
2018年昆明市农业局直属事业单位招聘！	昆明市/ns,农业局直属事业单位/nt
2018年深圳航空飞行员招聘公告	深圳/ns
2018年潼关县公开招聘高层次和紧缺特殊专业人才面试工作圆满结束	潼关县/ns
2018年五指山事业单位编制招聘39人公告解读	五指山/ns
2018泉州市洛江区档案局招聘工作人员公告	泉州市/ns,洛江区档案局/nt
2018山西榆次区中西医结合医院招聘护理操作考试通知	榆次区/ns,山西/ns
2018芜湖繁昌县基层特定岗位招聘报名岗位核减公告	繁昌县/ns,芜湖/ns
2018芜湖繁昌县事业单位招聘工作人员成绩公布（医疗岗）	芜湖/ns,繁昌县事业单位/nt
2018宣城旌德县事业单位招聘岗位计划数取消公告	宣城/ns,旌德县事业单位/nt
2018淄博招警！去年一次招聘329人，今年比去年还多？	淄博/ns
北海适合养老吗？	北海/ns
北京工资1万8，在成都1万，我选哪里工作？网友们讨论炸了营	北京/ns,成都/ns
别以为日本丈夫工资往妻子卡里打了，这才是他们的家庭模式	日本/ns
亳州农民工有了“新武器”，看谁还敢拖欠农民工工资？！	亳州/ns
潮州湘桥区人民法院招聘10名辅警公告	潮州/ns,湘桥区人民法院/nt
成都，重庆，昆明与贵阳哪里买房养老好？	昆明/ns,贵阳/ns,成都/ns,重庆/ns
成都工资低吗？	成都/ns
都兰从源头治理拖欠农民工工资问题	都兰/ns
俄罗斯4万名老人集体到中国养老，通过迁居中国摆脱贫困！	中国/ns
防城港是否值得买房养老？	防城港/ns
夫妻两个人月工资加一起两万三，现存款五十万，能不能在上海买房子？	上海/ns
福建文博教育招聘｜未来同事请留步，这里有一份好工作！请查收！	福建/ns
抚顺市第四医院公开招聘高层次人才和紧缺人才	抚顺市/ns,第四医院/nt
该不该辞了杭州7000一个月的工资回家做淘宝？	杭州/ns
工资9500元！不限户籍、提供住房！新疆5月招聘12592人，都是好单位！快啭给身边需要的人……	新疆/ns
贵州省专项补助来了 这些基层医生要涨工资	贵州省/ns
海南哪座城市适合养老度假？	海南/ns
杭州一个月工资13000，你是选择在杭州买房定居，还是选择回老家四五线城市生活？	杭州/ns
好工作！内蒙古一大批单位招聘，岗位众多！	内蒙古/ns
河北1市事业单位招聘最新公告！还有一大拨好单位等你来	河北/ns
黑龙江“抢”人了！招聘1186人，安家费最高给25万……	黑龙江/ns
黑龙江哪个城市最适合养老？	黑龙江/ns
吉林省22家事业单位招聘361人	吉林省/ns,事业单位/nt
江西28名农民工被欠薪，老板以29万块砖相抵，你怎么看？	江西/ns
江西省樟树市企业2018年招才引智招聘公告	江西省/ns,樟树市/ns
江西中瑞陶瓷转租三年，2000万/年转租费却发不了农民工80万工资？	江西/ns
靠工资在贵阳买房现实吗？	贵阳/ns
昆明电机厂有限责任公司2018年招聘信息	昆明/ns,电机厂有限责任公司/nt
昆明适合养老吗？	昆明/ns
昆明至少200余公租房租户拖欠房租或被列入社会信用体系黑名单	昆明/ns
来成都养老，成都哪个区生活最好？	成都/ns
绿地还要赖多久？拖欠海南数百家分销上千万佣金长达四五年！	海南/ns
买房养老，北海和海南你选择哪里？	北海/ns,海南/ns
每个月6000元的工资，在哈尔滨生活的怎样？	哈尔滨/ns
觅房网-寻觅你未来的生活方式！无锡觅房科技高薪招聘销售人员	无锡/ns
民工工资实行专用账户管理 江阳区完成8个在建项目试点	江阳区/ns
目前中国哪个城市养老基金余额最多，为什么？	中国/ns
南方哪个城市更适合养老？杭州，深圳，珠海，还是其他？	珠海/ns,杭州/ns,深圳/ns
南京、苏州、杭州哪个城市更宜居，更适合养老？	苏州/ns,杭州/ns,南京/ns
南宁房价跟南宁工资差距大不大？	南宁/ns
年薪最高100万！东莞和省内大批事业单位招聘，你的机会可能来了	东莞/ns,事业单位/nt
青海省公共设施建设投资有限责任公司招聘公告	青海省/ns,投资有限责任公司/nt
青海省原民办代课教师得到了较好的下岗待遇和养老保障，算不算恢复了教师身份？	青海省/ns
泉州养老服务体系建设提速 今年将增养老床位3840张	泉州/ns
日本护理人才短缺 政府通过提高薪资引进机器人“救急”	日本/ns
日本仙境小镇招聘住院医师：2200万日元年薪，房子水电煤气全包	日本/ns
瑞昌多部门联合 为92名农民工讨回欠薪逾136万元	瑞昌/ns
三亚、威海，只能选择一个地方买房养老的话，你会选择哪一个？	三亚/ns,威海/ns
三亚和厦门哪个城市更适合养老定居？	三亚/ns,厦门/ns
山西省将举办县级医疗集团人才招聘大会	山西省/ns,县级医疗集团/nt
山西太原市教育局直属中小学校招聘拟录用人员	山西/ns,太原市教育局直属中小学校/nt
山西县级医疗集团人才招聘大会5月26日举行	山西/ns,县级医疗集团/nt
上班像度假年薪26万，英国小岛正在招聘“岛主”	英国/ns
上海社保正好交满15年，退休工资每月可拿多少？	上海/ns
深圳东莞湛江，哪个城市月消费最低、工资最高、生活最安逸？	湛江/ns,东莞/ns,深圳/ns
深圳工资7000怎么样？	深圳/ns
事业单位 马鞍山含山县招聘政府工作人员5人	马鞍山/ns,含山县/ns
手里有20万全部家当，目前单身一人在杭州工资很低6500，奔三了快，关于房子我该怎么办？	杭州/ns
四川哪些地方冬暖夏凉，房价也不高，适于养老？	四川/ns
天津诚筑说招聘，个人经历分享	天津/ns
威海渔船上工资很高吗？	威海/ns
为什么山东工资水平比南方几省工资低很多，特别是住房公积金？	山东/ns
为什么武汉工资低，生活成本却很高？	武汉/ns
为什么像厦门这种城市物价房价高，工资却很低呢？这是典型旅游城市的通病吗？	厦门/ns
为什么郑州工资低，房价却居高不下？	郑州/ns
未来20年，谁来为中国老人养老！	中国/ns
西安的房价涨的过万了，到买房的人还这么多，你工资购买一平方吗	西安/ns
西安房价透支，知名国企工程师工资竟没月供高，1年只够买4.5 平	西安/ns,知名国企/nt
西安工资6000是什么水平？	西安/ns
西宁人快看！你的工资又要涨了，而且还能涨不少呢~	西宁/ns
现在在云南买房养老好不好？	云南/ns
香坊区法院2018年公开招聘政府雇员 5月5日开考	香坊区/ns
想在海南买房养老，买个小户型需要注意些什么？	海南/ns
养老型旅居置业 海南全域限购只是个开始！	海南/ns
养老养生，建议你可以来海南瞧一瞧！	海南/ns
养老自住而论，东莞、惠州和中山，选哪里好？	中山/ns,东莞/ns,惠州/ns
一个月5000左右的工资，可以在西安买一套房子吗？	西安/ns
一季度重庆居民人均收入又涨了 你的工资适合在哪里买房？	重庆/ns
英国各大城市工资低于平均？伦敦之外，最高薪竟在这里	英国/ns
英媒：工资不堪重负，曼联今夏将大清洗！巴萨盼下周搞定中卫续约	中卫/ns
永济市公安局公开招聘警务辅助人员体能测评公告	永济市/ns
越南的普工工资已经超越中国普工了，是真的吗？	中国/ns
越南人来广西打工砍甘蔗, 工资比在越南上班多几倍!	广西/ns
在成都5000块工资是什么水平？	成都/ns
在苏州，靠工资买房到底现不现实？	苏州/ns
在西安每个月5000的工资能买房吗？	西安/ns
在西安月薪15K，深圳应聘月薪25K，是否该举家搬迁深圳？	西安/ns,深圳/ns
在西部城市南宁，一个月工资达到多少才能算过得舒服？	南宁/ns
在中山一个月5000元工资可以吗？	中山/ns
在重庆，大家的工资跟得上房价的涨幅吗？	重庆/ns
怎么看待江苏三个城市薪酬排进全国前20，可房价比他们的工资高5倍？	江苏/ns
湛江为什么比三亚更适合北方老年人养老？	三亚/ns,湛江/ns
招聘｜通辽市精神卫生中心招聘工作人员(10号截止）	通辽市/ns,精神卫生中心/nt
浙江国企招聘：2018衢州市衢江区区国有企业公开招聘工作人员22人	浙江/ns,衢江区/ns,衢州市/ns
郑州入选一线城市，但普遍工资3000左右，房价也高，收支严重不符，对此你怎么看？	郑州/ns
中国哪个省城更适合养老居住呢？	中国/ns
中国十大养老胜地！真想去这里养老	中国/ns
中国铁路昆明局集团2018年招聘考试成绩查询通知	中国/ns,铁路昆明局集团/nt
中国维和部队有工资吗？不仅有，而且高到超出你的想象！	中国/ns
最新黑河市二院招聘医疗技术人员6人‖嫩江县热电厂招聘10人	嫩江县/ns,黑河市/ns,二院/nt
2018年打响夏季“两业”攻势，“精准扶贫，送岗下乡”桐柏专场招聘会	桐柏/ns
广西新政策：招聘一名乡村教师财政补助10000元	广西/ns
河南省南阳市宛城区一名教龄18年的乡村教师，2018年每月实发2800元工资，对此你怎么看？	南阳市/ns,河南省/ns,宛城区/ns
农村小伙放弃外出广州打工，在家乡三千工资被迫去跑滴滴	广州/ns
山西农村老人两亲家养老同住地坑院，看看生活是啥样	山西/ns
这些越南农民跑到广西农村打工，你知道他们一天工资是多少吗？	广西/ns
“抢人”与“留人”大战打响！吉林工师应用型人才专场招聘会火爆	吉林/ns
「5月」山东各地地区国企招聘1000+人，报名时间紧急，勿错过！	山东/ns,地区国企/nt
「招聘」浙江水利水电学院招聘啦！	浙江/ns
「重磅」无笔试！5月21日报名！德州招聘事业单位教师100人！	德州/ns
1000多个岗位！南京文化人才专场招聘会下周六开启！	南京/ns
2018安徽机电职业技术学院招聘17人公告	安徽/ns,机电职业技术学院/nt
2018安徽机电职业技术学院招聘编外人员17人公告	安徽/ns,机电职业技术学院/nt
2018安徽教师招聘公告什么时候发布？	安徽/ns
2018安徽教师招聘考试 安徽教师招考网信息更新	安徽/ns
2018安徽教师招聘考试公告什么时候发布？	安徽/ns
2018安徽教师招聘考试——致正在焦虑等公告的你	安徽/ns
2018安徽宿州砀山县中小学教师招聘职位表下载	安徽/ns,砀山县/ns,宿州/ns
2018滁州凤阳县经济发展投资有限公司招聘工作人员笔试成绩公示	凤阳县/ns,滁州/ns
2018东平县教师招聘明天开考，考场分布图抢先看！	东平县/ns
2018阜阳市妇女儿童医院校园招聘拟录用人员公示	阜阳市/ns
2018广西教师招聘考试笔面试成绩计算方式	广西/ns
2018广西教师招聘考试时间已确定，该如何备考？	广西/ns
2018河南农信社招聘网申填写及注意事项	河南/ns,农信社/nt
2018河南烟草公司招聘时间、招聘条件	河南/ns,烟草公司/nt
2018湖北农信社招聘四个关键助力备考	湖北/ns,农信社/nt
2018江苏烟草专卖局校园招聘信息、报名条件	江苏/ns
2018九江事业单位招聘考试网上报名专题	九江/ns
2018年安徽省淮南市直机关幼儿园招聘教师15人公告	安徽省/ns,淮南/ns
2018年广西教师招聘面试形式汇总	广西/ns
2018年广西教师招聘面试形式汇总：各地区面试形式如何？	广西/ns
2018年贵州省事业单位招聘工作人员联考，你准备好了吗？	贵州省/ns
2018年湖北省武汉东西湖区事业单位招聘面试公告	湖北省/ns,武汉东西湖区事业单位/nt
2018年济南市章丘区教育体育局所属事业单位公开招聘教师简章	济南市/ns,章丘区教育体育局所属事业单位/nt
2018年吕梁市经信委、煤炭工业局事业单位公开招聘笔试准考证打印	吕梁市/ns,信委/nt,煤炭工业局/nt
2018年玛曲县中小学代课教师招聘公告	玛曲县/ns,中小学/nt
2018年南昌市红谷滩新区招聘教师306人公告	南昌市/ns
2018年陕西安康市教育局公开招聘高层次人才25人	陕西/ns
2018年陕西西安市事业单位招聘笔试温馨提示	陕西/ns,西安市事业单位/nt
2018年汕头市妇女联合会属下幼儿园（托儿所）公开招聘24人公告	汕头市/ns
2018年四川省特岗教师招聘4200人	四川省/ns
2018年四川省特岗教师招聘简章	四川省/ns
2018年四川省招聘特岗教师4200名 今天开始报名	四川省/ns
2018年四川省招聘特岗教师4200名，其中初中1687名，小学2513名！	四川省/ns
2018年无锡市新吴区教育系统公开招聘教师（一）拟录用名单公示	无锡市/ns
2018年宿迁市市属事业单位第一批公开招聘（选调）资格复审公告	宿迁市/ns
2018年诸城市普通高中学校公开招聘优秀毕业生面试公告	诸城市/ns
2018青岛李沧区幼儿园幼儿教师招聘100人公告	青岛/ns,李沧区幼儿园/nt
2018山西榆次区中西医结合医院招聘护理操作考试名单	榆次区/ns,山西/ns
2018深圳教师招聘面试考什么？	深圳/ns
2018四川农信社（农商行）招聘笔试成绩为何天壤之别	四川/ns,农信社/nt,农商行/nt
2018苏州市吴江区事业单位招聘笔试成绩查询及资格复审公告	苏州市/ns,吴江区事业单位/nt
2018西安丝绸之路国际电影节有限公司招聘公告	西安/ns
2018宿迁市属事业单位第一批公开招聘（选调）资格复审公告	宿迁市/ns,市属事业单位/nt
2018宿州灵璧县人民法院招聘书记员，司法警察面试相关事宜的通知	宿州/ns,灵璧县人民法院/nt
2018宿州灵璧县人民法院招聘书记员入围面试人员名单	宿州/ns,灵璧县人民法院/nt
2018中国——马来西亚钦州产业园区第一小学、第一中学招聘公告	中国/ns,钦州产业园区第一小学/nt,第一中学/nt
5月12日 湖南省展览馆大型应届毕业生专场招聘会	湖南省/ns
艾唯尔机器人成功应聘日本烤肉店服务员，专业服务引来好评！	日本/ns
爱奇艺招聘拒绝河南 可你知道河南为全国提供了多少廉价粮食吗	河南/ns
安徽本科毕业5年工资最高竟然是这所大学……	安徽/ns
安徽省教师招聘公告发布时间	安徽省/ns
报名分析｜杭州西湖区教师招聘仍有27个岗位不足开考！	杭州/ns,西湖区/ns
北京市 举办2018年退役大学生士兵专场招聘会	北京市/ns
北京市举办2018年退役大学生士兵专场招聘会	北京市/ns
北京市举行2018年退役大学生士兵专场招聘会	北京市/ns
北京市某区非教师岗2018年招聘考试分析报告	北京市/ns
本科就能报！青岛疗养院、山东大学……又一波省属事业单位招聘	青岛/ns,波省属事业单位/nt
本科生最多可补贴18万元 急需专业应聘安排住五星 绍兴上虞今天跑到杭州“抢人才”来了！	杭州/ns,上虞/ns,绍兴/ns
不限户籍！山东招聘教师412人！	山东/ns
惨！欧洲球队拖欠国安上百万转会费，一年了还没还上	欧洲/ns
成都烟草的招聘时间和条件？	成都/ns
大专以上 安徽机电职业技术学院招聘编外人员17人	安徽/ns,机电职业技术学院/nt
德州经开区公开招聘100名中小学教师 5月21日至23日报名	开区/ns,德州/ns
德州市属事业单位集中公开招聘今日笔试	德州市/ns,市属事业单位/nt
德州市属事业单位招聘今日笔试 平均竞争比66.3:1	德州市/ns,市属事业单位/nt
鼎城区将公开招聘教师174名	鼎城区/ns
定了！雄安招聘教师650名！附带河北最新招聘信息汇总！	河北/ns
东台市2018年教师招聘考试面试人员名单公布！	东台市/ns
福建大学生毕业招聘会：男女生毕业季找工作，现场竞争激烈	福建/ns
阜阳这些单位公开引进、招聘290人，快转给身边朋友！	阜阳/ns
工资2万一个月，能在厦门立足生活吗？	厦门/ns
工资连降3级！恒大五人就球衣事件受罚，一细节尽显中国足球真面目	中国/ns
公告｜2018年四会市公开招聘教师110人	四会市/ns
广州恒大处理装备管理问题：俱乐部总经理被通报批评工资降三级	广州/ns
贵州一个小县城的老师，参加工作一年半，工资到手3250加绩效12000算不算低？	贵州/ns
河南的教师招聘是什么时候？	河南/ns
黑龙江省首办高校及科研院所人才引进专场招聘会 安家费最高给25万	黑龙江省/ns
湖北今年公开招聘农村义务教育学校教师7991人，4.5万余名考生报考	湖北/ns
湖北省今年公开招聘7991名农村教师 部分热门岗位录取率43:1	湖北省/ns
湖南5月教师招聘最新岗位1823个职位	湖南/ns
环卫大叔每月用一半工资去健身房 获江苏健美冠军	江苏/ns
吉林工师应用型人才专场招聘会助力吉林经济振兴	吉林/ns
江苏事业单位招聘！2018泗阳县事业单位招26人	江苏/ns
江西一大波学校招聘教师 共有306个席位等你来	江西/ns,波学校/nt
教师招聘：2018四川省特岗教师招聘4200人	四川省/ns
教师招聘重要考点备考之中国古代教育专题	中国/ns
今起报名！四川省今年招聘4200名特岗教师（内附岗位招聘表）	四川省/ns
就想问问，有没有打算或者考虑过来海南购房的…投资置业、旅游度假、养生养老等等？	海南/ns
就业对接直入校园 广州大学城创新招聘会吸引过千人参加	广州/ns
考2018邯郸特岗教师招聘，该准备些什么？	邯郸/ns
昆明电机技工学校2018年招聘简章	昆明/ns,电机技工学校/nt
乐山招聘特岗教师，开始报名了	乐山/ns
李沧区幼儿园又招聘？这次要招100人！	李沧区/ns
李沧区招聘100名合同制幼师 要求年龄35岁以下	李沧区/ns
莫错过！北京退役大学生士兵专场招聘会3000多岗位等你挑选	北京/ns
莆田侨职举行2018年应届毕业生校园招聘会	莆田/ns
球员工资只是冰山一角，新疆的“土豪”体现在后勤保障上！	新疆/ns
日本人工资是中国6倍，为什么街上没有一辆豪车？	中国/ns,日本/ns
三门峡开发区区直幼儿园教师招聘简章	三门峡/ns,开发区区直幼儿园/nt
三亚举办民营企业高校毕业生专场招聘会 431家单位现场“揽才”	三亚/ns
厦门市同安区2018教师公开招聘资格复审通知	同安区/ns,厦门市/ns
山东大学青岛校区2018年第一批专业技术岗位招聘公告	青岛/ns
山东事业单位-教师招聘又来一波！45周岁以下，5月14日报名！	山东/ns
陕西省气象部门事业单位2018年度公开招聘全日制普通高校应届毕业生公告	陕西省/ns
上岸后的幸福生活 洪湖市举办专场招聘会帮助渔民	洪湖市/ns
上海非师范专业，能否应聘高中老师吗？	上海/ns
上海工资两万，考上了郑州的公务员要去吗？	上海/ns,郑州/ns
绍兴上虞副区长率队抢人：来应聘免费食宿，住五星级酒店	上虞/ns,绍兴/ns
绍兴市人力资源和社会保障局下属事业单位 2018年应届毕业硕士研究生招聘公告	绍兴市/ns,社会保障局/nt
深圳教师招聘笔试客观题考情分析	深圳/ns
深圳教师招聘笔试主观题考情分析	深圳/ns
深圳教师招聘考试笔试技巧及复习知识点	深圳/ns
深圳南山公办中小学招聘99名教师	南山/ns,深圳/ns
事业编制！三亚公开招聘9名特殊教育学校教师	三亚/ns
事业编制｜乌海广播电视台招聘4名播音员	乌海/ns,广播电视台/nt
数百名企进校“揽人才” 山东商职院2018年春季就业专场招聘会举办	山东/ns
四川今年将招聘4200名特岗教师 5月8日起报名	四川/ns
四川省今年招聘4200名特岗教师！	四川省/ns
四川省招聘特岗教师4200名 5月8日-14日网上报名	四川省/ns
四川省招聘特岗教师4200名 5月8日—14日网上报名	四川省/ns
苏州工资8000左右算什么水平？	苏州/ns
苏州昆山教育系统面向全国公开招聘47名在职骨干教师	苏州/ns,昆山/ns
泰安教师招聘准考证打印入口！	泰安/ns
泰安人速看：免学费还有工资拿！山东农业高校招收定向培养生	山东/ns
潍坊高新技术产业开发区事业单位招聘	潍坊/ns,高新技术产业开发区事业单位/nt
武大说自己是湖北第一高校！华科不服！毕业生薪酬说明了一切！	湖北/ns
香港澳门工资那么高，为什么大家不去香港澳门打工？	澳门/ns,香港/ns
兴宁有一帮大学生，每天做到凌晨2点，却只拿500元工资！	兴宁/ns
研究生毕业，在上海找工作一般要求多少工资比较正常？	上海/ns
盐亭县今年招聘39名特岗教师，今起报名！	盐亭县/ns
一群广州恒大工作人员被降了三级工资，昨天晚上到底咋回事？	广州/ns
宜宾今年将招聘258名特岗教师 6月笔试	宜宾/ns
用15号改成5号！降三级工资！广州恒大官方处分相关人员！	广州/ns
云南和海南，哪里更适合养老？	海南/ns,云南/ns
云南省又出新公告了！招聘2919人，专科即可报名！	云南省/ns
云南最适合养老的六个城市，你喜欢谁？有你的家乡吗？	云南/ns
在西安，工资5000以上是怎样一种体验？	西安/ns
赞！北京市举办2018年退役大学生士兵专场招聘会	北京市/ns
招聘！济南大学城实验高级中学公开招聘76人	济南/ns,实验高级中学/nt
招聘｜罗湖区公办中小学65个岗位等你来，报名已启动！	罗湖区/ns
招聘信息丨下周南京有一场大型招聘会，时间、地点看这里→	南京/ns
找工作的你，5-7月四川这些招聘会你不能错过！	四川/ns
这场校园招聘会上，一家武汉企业开出60万年薪	武汉/ns
这些火的一塌糊涂的中国造实用车品，发工资剁手也得买，真上档次	中国/ns
浙江上虞抢人才：毕业生去当地参加招聘活动可获免费食宿	浙江/ns,上虞/ns
郑州一学校总出“经适男”，毕业工资3000块，女生：适合当我对象	郑州/ns
中国造功能型车品，瞬间让你爱车升上顶配，发了工资剁手也得买	中国/ns
终于出了！2018四川省特岗教师招聘公告已发布，4200人！	四川省/ns
重要消息！深圳教师招聘无人报考岗已出！	深圳/ns
注意啦，南昌红谷滩新区公开招聘中小学、幼儿教师306名	南昌/ns
转需！四川招聘4200名特岗教师，开始报名！（内附详细岗位）	四川/ns
“东川泥石流”ss2赛段江西五十铃三台柴油量产车安抵终点	江西/ns
5.12汶川地震十周年，你是否在地震带上？	汶川/ns
5.12汶川特大地震10周年 看原国道213遗址仍然触目惊心	汶川/ns
大医精诚 一名骨科医生的汶川地震十年感悟	汶川/ns
地震10年之后的汶川县，那些地震后留下的遗迹依旧震撼人心	汶川县/ns
苦难应该被铭记，更应该被遗忘——纪念汶川地震十周年	汶川/ns
流传十年的汶川地震短信：你只有经历生死，才能体会生活的真相	汶川/ns
每日念叨“佛系”消防，远离火患保平安	保平安/ns
如果能回到十年前，我想告诉你汶川今天会地震！	汶川/ns
厦门大暴雨洗礼鹭岛，朋友圈的说说经典画面	厦门/ns,鹭岛/ns
十年后，2008 年汶川地震产生了哪些影响？带来了哪些变化？	汶川/ns
十年前5.12汶川地震的那一刻，你在做什么？	汶川/ns
台风“天鸽”把珠海一小区的地下停车场全淹没，被淹的车辆可怎么处理啊？	珠海/ns
汶川512地震10周年，我们用怀念的方式纪念，让人人都享受幸福	汶川/ns
汶川地震10周年纪念 自驾车2次到北川的记录	汶川/ns
汶川地震十年了，回顾那些定格的瞬间，很多人难忘	汶川/ns
汶川地震十周年：回忆是苦的 未来是向前的	汶川/ns
汶川地震受灾最重地点十年今昔对比图 让人震撼让人感伤让人欣慰	汶川/ns
西南油气田多供气支援汶川地震灾区重建	汶川/ns,西南/ns
越南西贡15小时内连降暴雨，一线城市变水城	西贡/ns
这辆“史上最牛汽车” 如今陈列在汶川特大地震纪念馆	汶川/ns,地震纪念馆/nt
中国造“车载神器”大火！高速开140静到吓人，难怪经常断货！	中国/ns
后院失火？中美贸易战一触即发，美商却集体点赞中国	中国/ns
锦城点金：5.12周评黄金走势止住多头地震，原油空头料崛起	锦城/ns
聚焦汶川地震孤儿成长历程 中国人寿联合拍摄纪录电影龙江献映	中国/ns,龙江/ns,汶川/ns
汶川地震十周年 记录电影《川流不息》在陕献映	汶川/ns
汶川地震十周年：一场地震如何改变几座城	汶川/ns
汶川地震中那些死难者存在银行里的钱，最后怎么处理了？	汶川/ns
北京猛刮共有产权风，深圳多云，广州会下暴雨吗？	北京/ns,深圳/ns
探访地震极重灾区汉旺：废墟遗址屹立十年 守望新城蝶变重生！	新城/ns
外媒看汶川地震十年：重生后的新生活	汶川/ns
汶川大地震之后：汶川，有一种热度……	汶川/ns
汶川地震已过去十年，昔日的灾区，汶川人崭新的生活	汶川/ns
“汶川地震十周年·我与汶川共奋进”⑾“汶川三宝”带动灾区转型发展脱贫奔小康	汶川/ns
“汶川地震十周年·我与汶川共奋进”⒀震后10年寄托全村致富希望，樱桃格外甜	汶川/ns
90后女孩亲历汶川地震，毕业后返乡带领村民卖水果，年销300多万	汶川/ns
广西现2元一斤猪肉，暴雨又淹猪场！中国开始严查进口美猪肉！	中国/ns,广西/ns
汶川地震里的坚强猪，可能成“第一头家养的、能够寿终正寝的猪”	汶川/ns
汶川地震十年 港大建筑师助灾区村庄“重生”	汶川/ns
汶川地震十年，感恩有你！人民网头条聚焦十年巨变	汶川/ns
汶川地震十年：村美民富产业旺 乡村振兴谱新篇	汶川/ns
汶川地震十年后，这个国家级贫困村，如何做到人均收入翻十倍？！	汶川/ns
汶川地震十周年｜金台村的“重生”：屋顶种菜门口卖	汶川/ns
汶川地震灾区扶贫记：“电商车厘子”货销全国	汶川/ns
汶川地震震后十年：90后亲历者靠电商卖山货带全村致富	汶川/ns
“辉煌重建 感恩中国”5.12汶川地震10周年纪念活动在京举行	中国/ns,汶川/ns
“十年·十人”汶川地震十年祭 一代芳华未尽 十载重生记忆	汶川/ns
“十年·十人”汶川地震十年祭（十）一代芳华未尽 十载重生记忆	汶川/ns
“汶川地震十周年·我与汶川共奋进”⒁探访汶川新城 感受十年间从灾变到巨变	汶川/ns,新城/ns
“无腿蛙王”代国宏：汶川地震十年后收获冠军和爱妻	汶川/ns
「5·12汶川地震十周年」云朵上的幸福时光	汶川/ns
「行动起来！」洛阳消防“四条主线”推进防灾减灾周宣传工作	洛阳/ns
「特别策划」汶川地震十年，灾区十景重辉——走进十个特重灾区那些标志性旅游景点	汶川/ns
「汶川地震十年」汶川水磨古镇：“山水”结缘 涅槃重生	汶川/ns
「重磅」为纪念汶川地震10周年，毕棚沟5月12日对所有人免门票！	汶川/ns
10年前日记：汶川大地震6分钟后 北川现场拍摄者见证悲怆时刻	汶川/ns
5.12地震十周年：一起来看看2011年的青川东河口地震遗址公园	河口/ns
5.12汶川地震10周年：不灭梦想 以足球的名义让爱延续	汶川/ns
5·12汶川特大地震纪念馆开放公告	汶川/ns,地震纪念馆/nt
512”汶川大地震十周年祭，中国力量铸就重建奇迹	中国/ns,汶川/ns
512汶川地震10周年，回忆，是为了不遗忘	汶川/ns
66中联合大坪小学开展纪念汶川地震十周年活动	汶川/ns
NBA中谁在四川大地震中捐助最多？这就是球迷们喜爱他们的原因	四川/ns
暴雨来袭，厦大被迫停课，华南各大高校开启“看海”模式	华南/ns,厦大/ns
成都画院纪念5.12汶川地震十周年全国书画名家赈灾作品回顾展开幕	汶川/ns,成都/ns
川足发海报悼念“汶川地震”，10年川足从中超陨落到中乙！	汶川/ns
地震10年，汶川没有什么新闻	汶川/ns
感动球迷！这两家中超俱乐部发布纪念“汶川地震”十周年海报	汶川/ns
感恩奋进 共建美丽九寨——写在5.12汶川特大地震十周年	汶川/ns
关于08年的记忆：汶川地震、打地铺、中考，还有篮球	汶川/ns
国内有条91公里高铁，和汶川地震有着极大关系	汶川/ns
好姑娘！中国女排队长朱婷发博表示对汶川地震的祝福	汶川/ns,中国女排/nt,朱婷/nr
淮阳县举行2018年“512”中小学生防空防灾应急疏散演练活动	淮阳县/ns
回忆：汶川地震那天NBA发生的比赛	汶川/ns
纪念“5·12” 汶川大地震十周年，看重灾区茂县如今面貌新	茂县/ns,汶川/ns
纪念汶川大地震，我们在行动——新浜幼儿园开展防灾防震演练活动	汶川/ns
纪念汶川大地震10周年《镜子背后的女人》在杭首发	汶川/ns
纪念汶川地震 四川众多作家研讨李西闽长篇小说《我为什么呼救》	四川/ns,汶川/ns
纪念汶川地震十周年，两支川足赛前为遇难者默哀	汶川/ns
江苏苏宁半场1-0领先长春亚泰，暴雨中双方都有机会，您如果看待上半场的比赛内容？	江苏/ns
今天是汶川地震十周年，发两首当时写的诗，也算是纪念吧！	汶川/ns
金安区双河镇新塘中学组织各班级召开防灾减灾主题班会	金安区/ns,双河镇新塘中学/nt
敬畏生命——写在汶川地震十周年	汶川/ns
旅游提示｜纪念汶川地震十周年！旅行中遇到地震要学会这些自救技巧！	汶川/ns
缅怀致敬——汶川大地震10周年	汶川/ns
铭记大难 珍爱生命 南充高中纪念汶川大地震大演练	南充/ns,汶川/ns
漠河的前世今生：大兴安岭火灾烧出来的旅游名城	漠河/ns,大兴安岭/ns
那年蝴蝶特别多 汶川地震周年祭幸存者睹物思人	汶川/ns
南县：疏散演练筑牢防灾减灾安全屏障	南县/ns
你还记得当年为512汶川地震捐款的金额吗	汶川/ns
迁安市彭店子乡高李庄幼儿园开展防灾减灾日宣传教育活动	迁安市/ns,彭店子乡高李庄幼儿园/nt
迁西三屯营中学举办防灾逃生演练	三屯/ns,营中学/nt
秋水晨曦：汶川大地震十年祭	汶川/ns
全国青少年防灾减灾教育基地在成都揭牌成立	成都/ns,青少年防灾减灾教育基地/nt
全国首发！成都发布减灾文化旅游导览图 含一号防空洞	成都/ns
厦门暴雨，车牌“失踪”，茫茫海中如何找寻你的车？	厦门/ns
山东枣庄：减灾防灾演练进校园	山东/ns,枣庄/ns
深圳业余联赛动人一幕：女友暴雨中为男友撑伞，谁说足球狗注孤身	深圳/ns
什邡“5·12”汶川地震发展振兴成就展中华世纪坛开幕	什邡/ns,汶川/ns
沈阳举行“防灾减灾”应急疏散演练活动	沈阳/ns
诗一首：纪念汶川大地震十周年有感	汶川/ns
十年涅槃 文化凝聚磅礴力量——汶川地震灾区文化重建与发展振兴报告	汶川/ns
十年前，汶川地震发生时我还只是个在遥远广东省的初中生	广东省/ns,汶川/ns
十年前之国殇-（汶川大地震）心仍有余悸	汶川/ns
十年丨汶川地震幸存者口述：我想吃爸爸做的青椒肉丝	汶川/ns
十年重生，让爱延续 中超各赛区播放汶川地震十周年纪念视频	汶川/ns
实拍 暴雨过后东莞出现三十六级大瀑布！	东莞/ns
说真话的武林大师！亲历汶川地震的青城派掌门人：救人非武术强项	汶川/ns
四川将为汶川地震十周年默哀：铭记伤痛，致敬重生	四川/ns,汶川/ns
四川汶川地震我们都知道，1933年那场大地震我们又知道多少呢？	四川/ns,汶川/ns
他在汶川地震中失去了双腿，如今拥有了爱情和事业	汶川/ns
探访汶川大地震遗址：5层楼只剩1层，10年前被压扁的桌椅仍在教室	汶川/ns
探访汶川地震遗址：有人竟在废墟中设合影点，给游客推销合影留念	汶川/ns
探秘、日本关东特大地震！	关东/ns,日本/ns
推广防灾减灾救灾的中国经验 服务“一带一路”沿线国家	中国/ns
汶川512地震十年后，我们一起踏上这片美丽的土地	汶川/ns
汶川大地震10年回顾 一个记者的个人日记：北川地震前的新闻B面	汶川/ns
汶川大地震NBA球员捐款，他一人占了三分之一	汶川/ns
汶川大地震高考没上一本复读610上人大，男生拉起她的手逃命后	汶川/ns
汶川大地震十年祭	汶川/ns
汶川大地震十周年，那些人，今天仍然令人潸然泪下	汶川/ns
汶川大地震十周年：灾区儿童用画笔告诉你什么叫做涅槃重生	汶川/ns
汶川大地震十周年纪念日，亲历者、四川籍作家推出长篇小说《镜子背后的女人》	汶川/ns
汶川大地震灾区考生上人大的高考励志故事，生死间她懂得了真爱	汶川/ns
汶川地震 十周年，珍惜今天的所有，明天和意外不知谁先来	汶川/ns
汶川地震，全国人民向遇难者哀悼	汶川/ns
汶川地震·十年：北川以绿色崛起	汶川/ns
汶川地震10年，汶川没有什么新闻，只有生活	汶川/ns
汶川地震10年：没有故事，只有生活 为死去的人默哀	汶川/ns
汶川地震10周年：“三川”换新颜，曾经的废墟如今变身旅游小镇	汶川/ns
汶川地震10周年：灾难面前，体育能贡献什么？	汶川/ns
汶川地震10周年纪念，记着那些感人的画面，映射出的人性美	汶川/ns
汶川地震10周年祭！永远铭记逝去的人们！感谢NBA捐出3000万美金	汶川/ns
汶川地震10周年祭，还记得那些为了保护学生牺牲的教师吗？感人伤痛	汶川/ns
汶川地震10周年特别报道 认真生活 如你所愿	汶川/ns
汶川地震NBA捐款3000万美金，科比一人占六分之一，奥登捐了40万	汶川/ns
汶川地震孤儿的婚礼：从一个家到另一个家	汶川/ns
汶川地震那只“猪坚强”，现在过的怎么样了？	汶川/ns
汶川地震十年 北川体育重生	汶川/ns
汶川地震十年，从最牛的教学楼到法式小镇！	汶川/ns
汶川地震十年，我来看看你	汶川/ns
汶川地震十年：没有故事，只有生活	汶川/ns
汶川地震十年后丨张映霜：我回到原点传承爱与温暖	汶川/ns
汶川地震十年记忆，网友：比地震更震撼的，是全国人民捐款的画面	汶川/ns
汶川地震十年祭：亲历灾区不泯的记忆，至今仍噙泪守望	汶川/ns
汶川地震十年了，北川中学现在很好，很好	汶川/ns
汶川地震十年了，十年生死两茫茫，不思量，自难忘	汶川/ns
汶川地震十年影像记忆，那位站在街头振臂呐喊的三轮车夫	汶川/ns
汶川地震十周年 航拍映秀遗址新貌	汶川/ns
汶川地震十周年 新华三二次援助青川七佛乡中心小学	汶川/ns,援助青川七佛乡中心小学/nt
汶川地震十周年！NBA球星谁在那年捐款最多？他们值得被球迷爱戴！	汶川/ns
汶川地震十周年！盘点NBA巨星捐款排行榜！科比最多，詹皇进前三	汶川/ns
汶川地震十周年，从QQ空间里翻出拍摄于6年前的汶川地震遗址照片	汶川/ns
汶川地震十周年，国内各球队悼念致敬重生	汶川/ns
汶川地震十周年，谁还记得他们？	汶川/ns
汶川地震十周年，这些故事要讲给孩子听！	汶川/ns
汶川地震十周年，中超多家俱乐部发文缅怀	汶川/ns,多家俱乐部/nt
汶川地震十周年：“地震游”成为汶川经济稳定来源，你也想来看看吗	汶川/ns
汶川地震十周年：走进汶川地震纪念性旅游区，这是最好的纪念	汶川/ns
汶川地震十周年｜“范跑跑”当年真的错了吗？	汶川/ns
汶川地震十周年国际儿童绘画展在悉尼举行	汶川/ns
汶川地震甩下学生逃命“范跑跑”，这些年过得怎么样？	汶川/ns
汶川地震灾区10年新生，带你走进汶川	汶川/ns
汶川惊魂——汶川地震十周年纪	汶川/ns
汶川特大地震纪念馆已收集实物30多万件	汶川/ns,地震纪念馆/nt
汶川特大地震映秀震中纪念馆永久收藏“生命之花”雕塑	汶川/ns
午间星闻｜骑士35分大胜横扫猛龙，连续四年进入东区决赛；汶川地震十周年电影《破门》北京首映	东区/ns,汶川/ns,北京/ns
午间星闻｜众星发微博纪念汶川大地震十周年；重庆冰球队组建不足一月拿了全国第四	汶川/ns,重庆/ns
舞剧《舞·雷雨》在南京上演，用舞蹈将中国故事呈现给公众	中国/ns,南京/ns
一场暴雨为黄冈半马增添感动	黄冈/ns
以足球的名义 安纳普尔那将举行汶川大地震10周年默哀	汶川/ns
盈丰香港女子高尔夫球公开赛配对赛因雷雨中止 球员嘉宾热情不减	香港/ns
有心了！贵州恒丰主场屏幕播放汶川地震十周年纪念视频	汶川/ns,贵州/ns
长兴：娃娃灭火 防灾减灾	长兴/ns
这次地震对九寨沟的影响有多大？	九寨沟/ns
这里是漩口中学，512汶川地震的遗址，仍然保留着10年前的样子	汶川/ns,漩口中学/nt
中超第九轮，江苏苏宁2-0击败长春亚泰，暴雨中苏宁赢在了哪里？	江苏/ns
中超第十轮海报，这三家俱乐部情义满满，纪念汶川地震祝福母亲节	汶川/ns
中国女子坐排队3-2险胜俄罗斯夺冠，一人曾从汶川地震活下来	中国/ns,汶川/ns
中乙镇江文旅与四川安纳普尔那赛前，球迷悼念汶川地震遇难者	镇江/ns,汶川/ns,四川/ns
众篮球圈人士发文纪念汶川大地震十周年	汶川/ns
重读言恭达《悲歌汶川》，纪念汶川地震十周年	汶川/ns
专题：汶川地震10周年，他们都去哪了？	汶川/ns
走进汶川特大地震纪念馆，一双双没了主人的鞋子让人潸然泪下	汶川/ns,地震纪念馆/nt
足球高于生死！恒大球迷全场亮灯为汶川地震默哀	汶川/ns
“5·12”汶川地震救援官兵纪实：不曾忘却的汶川记忆	汶川/ns
“对不起，亲爱的我要结婚了”：汶川地震十年，他们还好吗？	汶川/ns
“汶川地震”十周年祭	汶川/ns
“阳光机组”成员十年后重飞救灾航线，看川西新面貌	川西/ns
「纪念」汶川地震十周年，那一天我们风雨兼程，无问西东	汶川/ns
10年来，驻川部队积极投身汶川地震灾区恢复重建	汶川/ns,驻川部队/nt
10年前的今年，纪念5.12汶川大地震10周年	汶川/ns
10周年！汶川地震感人瞬间，“敬礼男孩，微笑女孩”“总理的泪”	汶川/ns
14.6万子弟兵参加汶川地震救灾，请记住他们救灾的11个感人瞬间	汶川/ns
14.6万子弟兵在汶川地震中救灾的18个感人瞬间，22位烈士光荣牺牲	汶川/ns
1923年，此岛国发生地震，中国豪甩5亿捐助，8年后他们暴露了本性	中国/ns
2008年5·12汶川地震时，你在做什么？	汶川/ns
20余国外交官点赞汶川地震灾区建设新貌	汶川/ns
5.12汶川大地震十周年纪念反思	汶川/ns
5.12汶川地震十周年祭	汶川/ns
5·12汶川地震10周年，这些知识一定不要忘记	汶川/ns
5人升上将5人升中将｜汶川10年救灾将军	汶川/ns
安徽肥东：防灾减灾进校园	安徽/ns,肥东/ns
沉痛悼念！5·12四川汶川特大地震69227位遇难同胞	四川/ns,汶川/ns
沉痛悼念！5·12汶川特大地震遇难同胞	汶川/ns
从太空看东非洪水：索马里河流变湖泊，肯尼亚27万人无家可归	东非/ns
从汶川震后十年看解放军救灾功臣直升机的发展	汶川/ns
大地震让这个国家死伤惨重，中国无私予以援助，结果让中国人寒心	中国/ns
当年汶川地震，你亲身经历最难忘的事情是什么？	汶川/ns
悼念5.12汶川大地震遇难同胞	汶川/ns
东航飞行员参加5.12汶川地震救灾追忆	汶川/ns
二战日本航母甲板竟是木头造的？一炮就着火	日本/ns
风雨无阻｜聚焦实战练精兵——兰州支队地震救援拉动演练！	兰州/ns
福建武警：防汛抢险演练中成功营救落水人员	福建/ns
感动！那个在地震中降生的“帐篷娃”在上海有17个兵妈妈……	上海/ns
感恩救援官兵 汶川地震遗孤成高原武警战士	汶川/ns
贵州龙里：防灾减灾日里演练忙	日里/ns,贵州/ns,龙里/ns
回顾汶川地震发生后那些震憾人心的瞬间	汶川/ns
回看“5.12汶川特大地震”十年交通之路（四）	汶川/ns
纪念汶川地震10周年那些英雄与逝去的生命	汶川/ns
纪念汶川地震十周年 亲历者：好好活着，就是对亲人最好的纪念	汶川/ns
纪念汶川地震十周年——愿天堂没有地动山摇	汶川/ns
加州发生4.4级地震！大地震撼动美国西海岸，夏威夷大地震？	加州/ns
假如有一天日本大规模发生地震，那么中国会怎么做？	日本/ns
经历过10年前汶川地震的人，现在怎么样了？	汶川/ns
警钟长鸣，牡丹区举行学校地震应急救援综合演练	牡丹区/ns
敬礼娃娃、奇迹男孩、最美舞者……汶川地震十年后，他们都在哪儿？	汶川/ns
军人汶川地震中救灾的11个感人瞬间，15名勇士写下请战书立生死状	汶川/ns
军中‘男’丁格尔！走近机动部队男护士 曾在汶川地震立一等功	汶川/ns
看湿了眼眶！汶川地震第一现场11个震撼场景，守望相助躲避灾难	汶川/ns
泪奔！汶川地震第一现场18个震撼人心瞬间，遇难者抱团躲避灾难	汶川/ns
美国士兵救灾居然开枪射杀难民，中国军人截然不同！	中国/ns
美国夏威夷州大岛多次地震 火山喷发	夏威夷州/ns
美国夏威夷州发生6.9级地震，特朗普却在拿盟友“开刀”	夏威夷州/ns
美国岩浆冲天，日本北部地震已达8次！气象局：火山爆发警告	日本/ns
美军质疑解放军为什么在汶川救灾时不带枪？答案让美军脸红羞愧	汶川/ns
秘鲁今年已发生80余次地震	秘鲁/ns
缅怀：向救助过汶川地震的每一位普通人致敬！	汶川/ns
缅怀汶川大地震十周年，愿逝者安息，活者坚强感谢强大的祖国	汶川/ns
铭记丨汶川特大地震10周年，英雄不该被遗忘	汶川/ns
南加人梦中被震醒 地震是加州人无法逃避的问题 做好准备了吗？	南加/ns
你记得10年前汶川地震时那声吼吗？“别怨我，我是军人！”	汶川/ns
念时间定格，守初心不改——纪念汶川大地震的10年	汶川/ns
凝聚产生力量；团结诞生希望 ___汶川大地震十周年纪念	汶川/ns
欧洲“台风”战机图鉴，英国皇家空军成立100周年涂装	欧洲/ns,英国皇家空军/nt
盘点“汶川地震”救援飞机类型	汶川/ns
七年前的东日本大地震，至今让人难忘	日本/ns
七座动物泛滥的岛屿：日本猫岛可预报地震	日本/ns
确认！日本发生5.2级地震，气象局：2到3天内可能会有震动情况	日本/ns
日本车在缅甸大火，价格五年内猛涨！	缅甸/ns,日本/ns
日本处在震带中央，如果有一天日本大地震你会接受日本的难民吗？	日本/ns,震带中央/nt
日本的建筑为何可以经受住强震？	日本/ns
日本动物园组织地震演习，扮演动物的职员太入戏，演习变联欢	日本/ns
日本米其林三星割烹餐厅发生火灾，火势蔓延6栋建筑	日本/ns
日本哪里地震比较少？	日本/ns
日本有史以来最强的台风是哪个？	日本/ns
日本远离中国飘向太平洋，地震火山活跃，将滑入马里亚纳海沟？	中国/ns,太平洋/ns,日本/ns
声影丨闫妮、佟大为领衔，他们为汶川地震灾区送上最美好的祝福	汶川/ns
十年前的今天，汶川地震，我们永远记住，我们的恩人，我们的祖国	汶川/ns
十年前的今天，汶川地震了，我在……	汶川/ns
十年前的汶川地震时你在干什么？还记得那些军人吗？	汶川/ns
十年前广州两百特警赴川救灾 十年后已有两名战友离去	广州/ns
十年前有两支关键部队在汶川地震表现重要，现在其能力进步巨大	汶川/ns
十年前只能租这一利器救灾汶川，今已研制出更先进的一雪前耻！	汶川/ns
十年前租装备救灾汶川，现已研制出更先进的一雪前耻！	汶川/ns
四维画室｜纪念汶川地震10周年｜10年过去了，你还好吗？	汶川/ns
探访成都空军 近距离观察救灾力量新变化	成都/ns
特朗普承认耶路撒冷为以色列首都，为什么会引起中东“地震”？	中东/ns
特朗普宣布退出伊朗核协议 中东政局大地震的引线已经点燃	中东/ns
突发！日本北部已发生达8次地震，气象局：火山爆发警告！	日本/ns
外媒：汶川地震遗址成旅游景点 每年维护费用2000万	汶川/ns
万名网友忆汶川地震：一刻十年！十年前的今天，你在做什么？	汶川/ns
为何评估欧洲战斗机台风比阵风还好？	欧洲/ns
为什么美国加州的末日火灾还是没有扑灭，导致火灾已扩散4800倍？	加州/ns
为什么日本的房屋比中国更抗地震？看完这篇文章你就知道了	中国/ns,日本/ns
为什么日本今年多台风？	日本/ns
为什么日本驱逐舰失火烧毁却要赖中国方面？再多来几次就更解气了	中国/ns,日本/ns
为汶川地震十周年了 这些地震防灾减灾知识 你知道了吗？	汶川/ns
未来10年日本会发生8.5级以上地震吗？	日本/ns
未雨绸缪 居安思危 邓州人防加大专业队防灾减灾训练力度	邓州/ns
未雨绸缪、居安思危，邓州人防加大专业队防灾减灾训练力度！	邓州/ns
汶川 成长 十年后我国救灾防灾能力的蜕变	汶川/ns
汶川 希望 党和政府救灾侧记	汶川/ns
汶川大地震10年，不忍提及，又难放下！	汶川/ns
汶川大地震10年，你还记得“空降兵十五勇士”和那“惊天一跳”吗	汶川/ns
汶川大地震10周年，外媒刊发废墟照引网友唏嘘	汶川/ns
汶川大地震10周年之际，我们除了祭奠历史，悼念遇难者之外，如何面对地震呢？	汶川/ns
汶川大地震10周年之际，我们除了祭奠历史，悼念遇难者之外，应如何面对地震？	汶川/ns
汶川大地震不应忘记的救援功臣 空中”大力士“米-26直升机	汶川/ns
汶川大地震十年回望 灾难中的中国军人是最可爱的人	中国/ns,汶川/ns
汶川大地震十年祭：用美好生活，告慰逝者	汶川/ns
汶川大地震十年已过，国宝熊猫在人们爱的帮助下已重拾生活信心	汶川/ns
汶川大地震十周年 回首那些不能忘记的瞬间	汶川/ns
汶川大地震十周年：两支关键性的部队发展极快，能力大幅度提高	汶川/ns
汶川大地震十周年：重生的全家福	汶川/ns
汶川大地震遗孤，长大后成了高原武警战士！	汶川/ns
汶川的十周年纪念日：地震就真的没办法预测吗？	汶川/ns
汶川地震10年 记者回访抗震救灾英雄子弟兵	汶川/ns
汶川地震10年，还记得巴基斯坦援助的帐篷吗	汶川/ns
汶川地震10年，可还曾记得那些英勇无畏的搜救犬？	汶川/ns
汶川地震10年：依然为这些照片落泪	汶川/ns
汶川地震10年了，还记得那15位最美空投兵吗	汶川/ns
汶川地震10年了，这5个镜头依旧温暖！	汶川/ns
汶川地震10年了：那些死里逃生的人，都还在用力活着	汶川/ns
汶川地震10年启示录｜惨痛代价“催生”高标准建筑抗震设计规范	汶川/ns
汶川地震10周年，曾经的瞬间依旧会让人泪流满面！	汶川/ns
汶川地震10周年，回访“空降兵十五勇士”	汶川/ns
汶川地震10周年，回访″空降兵十五勇士″	汶川/ns
汶川地震10周年，那些曾经参加救援的人民子弟兵，你们还好吗？	汶川/ns
汶川地震10周年，幸存者的肖像	汶川/ns
汶川地震10周年：回首那些瞬间，我们依旧泪流满面	汶川/ns
汶川地震10周年：让我们携起手，共同悼念那些在地震中逝去的灵魂	汶川/ns
汶川地震10周年：人民养育我们，我们为人民服务	汶川/ns
汶川地震10周年：十年重生路	汶川/ns
汶川地震10周年：中国军人从5000米高空跃下，连续奋战50个小时	中国/ns,汶川/ns
汶川地震10周年丨航拍新北川 楼房拔地起 旧貌换新颜	汶川/ns
汶川地震发生，15名勇士五千米空降探路探信息为什么要写遗书	汶川/ns
汶川地震发生后，他们在余震中奔赴第一线救人……	汶川/ns
汶川地震废墟里的幸存者：命是赚来的，没有太多资格悲伤	汶川/ns
汶川地震该国总统亲自站着来的	汶川/ns
汶川地震给中国军队带来的惨痛教训，至今尚未完全解决！	汶川/ns,中国军队/nt
汶川地震过去十年我军实力上了层楼，应急反应能力大幅提高	汶川/ns
汶川地震过去十年有何变化？看对比照后仿佛时间静止一般	汶川/ns
汶川地震救援官兵回忆：每一次救援都历经生死考验	汶川/ns
汶川地震那些最感动的瞬间	汶川/ns
汶川地震日本伸出援手其目的何在？央视帮日本发声却惹人深思	汶川/ns,日本/ns
汶川地震十年！乘地铁时遇到地震我们应该怎么做？	汶川/ns
汶川地震十年，亲历者说……	汶川/ns
汶川地震十年，在你看见这篇文章的时候是否还记得十年前的今天？	汶川/ns
汶川地震十年：“常德敢死队”决战9天9夜	汶川/ns
汶川地震十年：聚焦中国应急管理之变	中国/ns,汶川/ns
汶川地震十年｜烈士母亲：十年思儿泪满衣	汶川/ns
汶川地震十年了，你还记得吗？	汶川/ns
汶川地震十周年	汶川/ns
汶川地震十周年 废墟之上，重塑山河！	汶川/ns
汶川地震十周年 我军应急救援能力大幅提升	汶川/ns
汶川地震十周年 武汉总医院：爱从未远离	武汉/ns,汶川/ns
汶川地震十周年 这些地震防灾减灾知识 你知道吗？	汶川/ns
汶川地震十周年，当年被埋四天被成功救出的“狗坚强” 如何了？	汶川/ns
汶川地震十周年，地震发生时，我们该如何保护自己！	汶川/ns
汶川地震十周年，那些勇敢的人现在生活得怎么样？	汶川/ns
汶川地震十周年，我们依然难掩伤痛，但仍要前行	汶川/ns
汶川地震十周年，有你们负重前行的努力，才有我们的岁月静好！	汶川/ns
汶川地震十周年：解放军用行动告诉我们什么是“人民的军队”	汶川/ns
汶川地震十周年：兰德智库认为有一种力量让美国羞愧	汶川/ns
汶川地震十周年：历史铭记的一刻2008年5月12日，14时28分！	汶川/ns
汶川地震十周年：她们始终以军人姿态冲锋在前	汶川/ns
汶川地震十周年：灾区人民的六大超级救星	汶川/ns
汶川地震十周年：志愿者到北川救援地的山东公安驻地慰问演出	山东/ns,汶川/ns
汶川地震十周年｜活着，一切都好！	汶川/ns
汶川地震十周年记忆碎片：抗震救灾官兵与亲人的“团圆宴”	汶川/ns
汶川地震十周年祭，说说这支也许不是最先到但或许是最后走的部队	汶川/ns
汶川地震十周年祭，愿世界再无灾难！	汶川/ns
汶川地震十周年将至，11幅惊心动魄的图片，盘点那些震撼瞬间	汶川/ns
汶川地震十周年丨曾立志当特警的叛逆少年成了一名军人	汶川/ns
汶川地震十周年再回首：能吊运挖掘机的直升机 当时全国只有一架	汶川/ns
汶川地震时，日本韩国有没有进行援助？答案你绝对猜错了	汶川/ns,日本/ns
汶川地震时，日本救援队其实是来盗取核资料的？看完你都不敢信	汶川/ns,日本救援队/nt
汶川地震时，日本救援队真的是来盗取核资料的？不要再被骗了	汶川/ns,日本救援队/nt
汶川地震时，日本派的救援队真没其他目的？值得深思！	汶川/ns,日本/ns
汶川地震时，他亲手联通1034条空中救援线，成为女儿心中最绚章节	汶川/ns
汶川地震幸存者的励志故事	汶川/ns
汶川地震遗孤，长大后成了高原武警战士	汶川/ns
汶川地震遗孤：长大后成了高原武警战士	汶川/ns
汶川地震应当被铭记，也应该被忘记	汶川/ns
汶川地震援建者回忆：“当初的命令我们都还记得”	汶川/ns
汶川地震中8个催泪瞬间，母亲对着废墟撕心裂肺的哭，孩子在里面	汶川/ns
汶川地震中的“敬礼娃娃”：长大后懂了敬礼的含义	汶川/ns
汶川地震中立大功的外国直升机，不够用，我国紧急从外国租了一架	汶川/ns
汶川地震最好的直升机依然是黑鹰，至今已有30高寿替代者尚未列装	汶川/ns
汶川救灾将军：5人升上将5人升中将	汶川/ns
汶川十年——那些“地震男孩”的近况	汶川/ns
汶川特大地震10周年：在纪念中凝聚进步的动力	汶川/ns
我的汶川地震印象	汶川/ns
熄灯号｜一名军嫂在汶川大地震中的自述	汶川/ns
下一次不知道是何时：日本历史上死亡人数最多的大地震	日本/ns
一次摔伤，让他“梦回”10年前：参与汶川救灾的经历	汶川/ns
有谁记得他，那个汶川地震中救出的小男孩，如今已是空降兵！	汶川/ns
又苦又累为啥要当兵？汶川地震的觉悟：为了在需要的时候体现价值	汶川/ns
中东土豪 400亿现金购买中国36枚导弹 汶川地震又捐给中国4亿	中东/ns,中国/ns,汶川/ns
中国军人救灾为什么不带枪，外国人十分不解的事，我们却都懂！	中国/ns
中国力量铸就重建奇迹——写在汶川地震十周年之际	中国/ns,汶川/ns
中国汶川地震的时候，日本韩国有没有进行援助？	中国/ns,汶川/ns,日本/ns
中领馆提醒中国公民远离夏威夷火山和地震高危险区域	中国/ns
钟声为谁而鸣——记汶川地震十周年	汶川/ns
重回现场｜高清大图带你回到10年前的汶川地震	汶川/ns
专访：“中国人民为我们送行的场景至今令人难以忘怀”——访汶川地震俄罗斯救援队原领队萨洛夫	中国/ns,汶川地震俄罗斯救援队/nt
子弟兵汶川地震第一现场救灾18个感人画面，22个生命光荣为民牺牲	汶川/ns
走近军中“男丁格尔”：他们曾在汶川地震废墟中救出300多人	汶川/ns
公开课北京暴雨 房子漏水怎么修	北京/ns
溧水挺住！一夜暴雨倾城+电闪雷鸣，朋友圈被淹，全城迟到	溧水/ns
洛阳新区今日一在建楼盘火灾原因在此！	洛阳/ns
浅谈挤压综合症——深圳滑坡幸存者可能面临的危险	深圳/ns
黑龙江省森林防火指挥部和黑龙江省气象局联合发布橙色森林火险预警信号	黑龙江省/ns,森林防火指挥部/nt
火患之上的东北农村文化logo	东北/ns
汶川大地震8周年，与去地震灾区13次支教	汶川/ns
汶川地震，该国总统是站着来的！飞机座椅全拆，只为多放救灾物资	汶川/ns
汶川地震太原消防救援队英雄群像——回忆，是为了铭记	汶川/ns,地震太原消防救援队/nt
武汉暴雨大水围城，专家提示北方雨季也要来啦，如何应对？	武汉/ns
武汉暴雨受灾 雷军心系家乡新捐无人机	武汉/ns
西宁消防为重点单位冬春火灾防控再敲“警钟”	西宁/ns
夏季消防安全检查，太原整改火患17859处	太原/ns
夏县消防查改火灾隐患杀出 “回马枪”	夏县/ns
新西兰地震，中国公民一等优待！转移国籍的明星别再回来了！	中国/ns
新西兰地震后，大批超级鲍鱼被掀上海滩，结果是。。。	上海滩/ns
新一轮强降雨将再次袭黔 贵州启动Ⅱ级应急响应	贵州/ns
新一轮强降雨已致湖南74.8万人受灾3人死亡	湖南/ns
杨展江摄影《来了就是深圳人--现场直击》，台风妮妲直击深圳。	深圳/ns
一组照片记录地震后的日本，感受那些让我们心生温暖的细节	日本/ns
意大利6.0级地震、缅甸发生6.9地震！地震来袭如何躲避？	缅甸/ns
隐患曝光存在重大火灾隐患 山西恒运制衣有限公司被责令整改	山西/ns,恒运制衣有限公司/nt
英国“台风”战斗机首次赴日韩演习，紧跟美国介入东北亚局势	东北亚/ns,英国/ns
鹰潭支队多措并举全面推进冬春火灾防控工作	鹰潭/ns
渝水大队除夕夜查保平安，面面俱到查火患	保平安/ns
玉山交警加强汛期道路交通安全防范工作	玉山/ns
元宵节烟花燃放有序 北京市火灾形势平稳	北京市/ns
源头防控 桐乡消防“清剿”批发市场火患	桐乡/ns
长白山交警认真部署汛期交通应急处置和事故防控工作	长白山/ns
长春今夜暴雨，气象台发布蓝色警报	长春/ns
浙江丽水发生山体滑坡	浙江/ns,丽水/ns
浙江仙居：塌方受阻的县道桐街线恢复通行	桐街/ns,浙江/ns
浙江仙居：台风过后公路抢修忙	浙江/ns
中东最富国家，汶川地震援助4亿，但他们说：中国人才是土豪	中东/ns,中国/ns,汶川/ns
中国十大火车站、十大机场、十大港口排行榜，有你家乡吗？（图）	中国/ns,十大机场/nt
中国有座塔藏有两颗佛祖舍利：地震不倒，雷击不焚，炮弹穿堂过	中国/ns
重磅｜福建实施消防行政许可、行政处罚、重大火灾隐患”三公示”	福建/ns
重庆今起大部地区有暴雨 东北部有大暴雨	重庆/ns
重庆遭暴雨2人亡 今起雨势明显减弱	重庆/ns
重庆长江沿线以北有强降水 注意防范山洪地质灾害	重庆/ns,长江/ns
重庆主城遭遇8月来最强降雨！市民冒雨出行	重庆/ns
注意了重要的事情说三遍 暴雨！暴雨！暴雨！预计8月29-31日黑龙江多地有暴雨大风阵风可达7-8级	黑龙江/ns
筑牢秋季安全防线 平湖消防打响火灾隐患围剿战	平湖/ns
最新 | 泰宁滑坡7人失联 现场发现31具遗体	泰宁/ns
最新！台风“鲇鱼”生成，或28日登陆！这次可能还是来福建！	福建/ns
青海消防全力做好元宵节期间社会面火灾防控工作	青海/ns
权威发布｜春节期间太原没有发生亡人火灾	太原/ns
全警动员 枕戈待旦 牙克石市春节期间实现零火灾	牙克石市/ns
日本的一场大地震，是如何改变世界历史进程的？	日本/ns
日本地震，人家赈灾品居然是纸壳箱	日本/ns
日本发生大地震中国援助五百万银元 日本却无情杀害华侨	中国/ns,日本/ns
日本福岛地震核辐射后，当地居民的生活	日本/ns
日本九州地震对稀土元素应用的影响	九州/ns,日本/ns
日本又地震，别只顾援助！恩威并施的国家才有出息	日本/ns
晒晒世界各国军队救灾照片，美军枪不离身，中国军人的睡姿最帅	中国/ns
山体滑坡道路受阻 普洱西盟交警全力保畅通	普洱/ns
深圳战胜14级“妮妲”强台风	深圳/ns
深圳致73死特大滑坡事故调查结果公布！	深圳/ns
什邡消防深入景区排查火灾隐患	什邡/ns
什邡消防突击娱乐场所 消除火灾隐患	什邡/ns
失火市场“千人大会”谈教训 朝阳夏季消防检查“再发力”	朝阳/ns
受贝加尔湖森林火灾影响呼伦贝尔市西部地区出现烟雾	呼伦贝尔市/ns
受琼州海峡台风（艾利）影响 Z201次列车变更广州终到	广州/ns
受台风“海马”影响 开往深圳方向多趟列车停运	深圳/ns
丽水滑坡：今早发生二次坍塌，救援队伍暂时撤出	丽水/ns
中医杂谈—杏苑小技	杏苑/ns
中国胶囊内镜临床应用指南	中国/ns
多伦县中医药进入发展黄金期	多伦县/ns
成都一护士职业暴露面临被辞退	成都/ns
广东仍处季节性流感发病高峰期	广东/ns
想在北京看病，先试试这些方法	北京/ns
香港流感爆发，中医怎么应对？	香港/ns
昏迷的病人能吃安宫牛黄丸吗？	安宫/ns
山西遴选18位中医参加岐黄工程	山西/ns
一类非常适合亚洲人群糖尿病的药物	亚洲/ns
我对中医“经络”的质疑｜中国科技报	中国/ns
划重点：中国宫颈癌和HPV疫苗那些事	中国/ns
河南一八个月宝宝长了三个肺，反复住院	河南/ns
春天哮喘易犯，用乌苏中医哮喘膏方防治	乌苏/ns
新型医疗落地西北  高品质医疗引关注	西北/ns
江苏省第二中医院肛肠科招聘高层次人才	江苏省/ns,第二中医院肛肠科/nt
江苏省第二中医院肛肠科周末门诊开诊通知	江苏省/ns,第二中医院肛肠科/nt
厦门开展遗传眼病基因诊疗，填补国内空白	厦门/ns
甘肃中医村医小技术治病经验（第九十期）	甘肃/ns
甘肃中医村医小技术治病经验（第九十二期）	甘肃/ns
甘肃中医村医小技术治病经验（第九十一期）	甘肃/ns
防控H7N9禽流感，看上饶县是如何做的?	上饶县/ns
甘肃中医村医小技术治病经验（第八十九期）	甘肃/ns
便民｜9月起，北京医保又要扩大报销范围！	北京/ns
甘肃中医村医小技术治病经验（第九十三期）	甘肃/ns
甘肃中医村医小技术治病经验（第九十七期）	甘肃/ns
甘肃中医村医小技术治病经验（第九十六期）	甘肃/ns
病例分享｜冠状动脉旁路移植术的麻醉镇痛管理	旁路/ns
甘肃中医村医小技术治病经验（第一百零二期）	甘肃/ns
江夏区金口中学课堂大变脸——中医来“问诊”	江夏区/ns,金口中学/nt
江苏省第二中医院大肠疾病免费筛查活动成功举办	江苏省/ns,第二中医院/nt
「聚焦医改」一图看懂北京市医药分开综合改革政策	北京市/ns
香港糖尿病护士：给你谈谈糖尿病患者日常8件事儿	香港/ns
杭州一男子因眼睛奇痒就医，睫毛里竟爬出3条虫！	杭州/ns
2017华东白内障与角膜病高峰论坛在厦成功召开	华东/ns
厦门遗传眼病诊疗中心将于9月15日召开启动仪式	厦门/ns,诊疗中心/nt
死亡人数已超香港非典时期，“最可怕”的流感来了	香港/ns
云南今天起正式开启宫颈癌疫苗注射 费用2349元	云南/ns
天津老大：糖尿病患者使用预混胰岛素，千万要摇匀！	天津/ns
杭州爆发“登革热”！进入秋季我们更要注意蚊虫叮咬！	杭州/ns
「CHC2017」中国50万高血压调查最新数据公布	中国/ns
约印入股安徽和天医管，逾亿元投资背后的基层医疗使命	安徽/ns
开展中国心衰中心建设和认证 提高心衰规范化诊治水平	中国/ns
中医拒绝疫苗？康熙年间俄国医师曾来中医痘诊科苦学种痘	俄国/ns
中国艾滋、乙肝共感染分布图绘出，乙肝能加速艾滋病发展	中国/ns
为什么中国高血压患者除了药物降压治疗，还要补充叶酸？	中国/ns
“预防近视，保护视力”香港的眼保健操怎么做，你造吗？	香港/ns
广东医院专科哪家强？健康有约将为你打造最权威求医指南	广东/ns
176名学生不知学校真名 招生机构承认借用“沈师”名头	沈师/nt
东方医院内分泌科 “糖尿病”治未病健康管理团队	东方医院/nt,治未病健康管理团队/nt
分级诊疗 绿色通道 社区医院、东方医院完成生命接力	东方医院/nt
昆明经济技术开发区2018年招聘同工同酬教师公告	昆明经济技术开发区/nt
北大清华生源学校今日在中港外国语学校挂牌	外国语学校/nt
长治紫坊农产品市场2018年5月5日农产品参考价格	长治紫坊/nt
靠数量究竟能不能打赢强大的美军，看看俄海军在1975年给出的答案	俄海军/nt
一名公安院校入伍大学生士兵的自述	公安院校/nt
国旗护卫队退役老兵礼毕后，十几个汉子扑向国旗放声痛哭	国旗护卫队/nt
“吃鸡”开发者工资曝光 韩国政府为其开特例	韩国政府/nt
军营才是企业家的黄埔军校，盘点那些当过兵的富豪	黄埔军校/nt
交通部：建立网约车“黑名单”	交通部/nt
交通部发布征求意见稿 将建立网约车“黑名单”	交通部/nt
交通部拟规定：网约车司机无证上岗或列失信黑名单	交通部/nt
交通部一周内5次“喊话”网约车，透露了什么信号？	交通部/nt
滴滴看来是摊上事了，交通部发话：别把约谈当作耳旁风	交通部/nt
交通部：建立网约车“黑名单” 司机无证上岗或列入黑名单	交通部/nt
交通部：农村公路建设不得拖欠工程款等款项	交通部/nt
交通部：农村公路建设不得拖欠工程款、工资	交通部/nt
交通部：农村公路建设不得拖欠工程款、工资、拆迁款	交通部/nt
交通部：农村公路建设不得拖欠工程款、农民工工资	交通部/nt
交通部：农村公路建设不得拖欠工程款工资	交通部/nt
交通部：农村公路建设不得拖欠工程款工资拆迁款	交通部/nt
2018联合国中文口译员招聘报名时间及条件 考试时间地点	联合国/nt
联合国警告肯尼亚洪灾后或有重大疫情	联合国/nt
火震跟地震一样吗？美国宇航局的火星探测器将揭晓答案	美国宇航局/nt
别等了，美团打车凉了！现实很骨感！	美团/nt
绝大部分滴滴外卖小哥选择回归，称还是美团挣钱踏实	美团/nt
未来坦克巅峰对决，俄制T-14要干掉美制M1A3，能成功吗	美制/nt
谁说枭龙战机卖不动？或将迎来首个东南亚用户：抢走美制F16生意	美制/nt
农信社和银行的区别你造么？事关工资快看！	农信社/nt
果树嫁接还求人？农业部刚出的“嫁接器”真厉害，轻轻一剪就搞定	农业部/nt
聚焦 | 农业部紧急部署当前农业防汛抗灾工作 强化指导服务 抓好生产恢复 减轻灾害损失	农业部/nt
聚焦 | 农业部紧急部署高温热害防范工作 科学防灾减灾确保早稻获得好收成	农业部/nt
“制定房地产税法”第四年被列为全国人大常委会预备审议项目	全国人大常委会/nt
实拍日本自卫队阅兵，看着这画面你们什么感受？	日本自卫队/nt
景区频现欺客宰客 文旅部：将推动旅游违法入刑	文旅部/nt
「新华社」南农“90后”硕士小夫妻的农场梦	新华社/nt
新疆军区某团携驻地开展“传承红色基因 担当强军重任”演唱活动	新疆军区/nt
新疆生产建设兵团第十二师西山农场开展环境美化绿化工作	新疆生产建设兵团/nt
英国皇家空军的复古流：现代台风与二战喷火战机的D日涂装编队	英国皇家空军/nt,日涂装编队/nt
中共中央国务院出台意见推进防灾减灾救灾体制机制改革	中共中央国务院/nt
《2018中国大学教学质量评价报告》四大榜单里有你们学校的名字吗	中国大学/nt
中国空军第五代战机——歼-20隐形战斗机	中国空军/nt
中国空军里程碑！歼20已具备全疆域作战能力	中国空军/nt
中国空军歼-20战机首次开展海上方向实战化训练	中国空军/nt
中国空军宣布歼20已经出海 同时却留下了二个巨大的谜团	中国空军/nt
中国女足这么厉害，一个月工资大概多少？	中国女足/nt
中青报：传统文化啥时候变成了棒打学生	中青报/nt
NBA球队有哪些收入来源，如何能支付起1亿美元起的球员工资？	NBA球队/nt
八五四分公司召开水稻插秧定标现场会	八五四分公司/nt
知名保险经纪公司招聘：水险理赔专员，韩语行政文员等	保险经纪公司/nt
中介诱导租户办房租分期贷 北京住建委立案调查	北京住建委/nt
二本西藏民族大学护理学专业，想考研究生，应该报考哪个学校？	西藏民族大学/nt
“挑刺报告”发布 房产数据“一片空白”不动产登记中心卡壳	不动产登记中心/nt
金诚集团人事地震 集团总裁或被免职	金诚集团/nt
“凝心聚力 趣味无限”城区教育中心校成功举行第二届趣味运动会	城区教育中心校/nt
2018滁州市第二幼儿园招聘幼儿教师公告	滁州市第二幼儿园/nt
川大附小开展地震应急疏散演练 培养学生应急行为习惯	川大附小/nt,川大附小/nt
「新华日报」村委管物业，探路小区自治	村委管物业/nt
各大房地产公司，是怎么做营销的？	房地产公司/nt
各大银行的工资是多少？	银行/nt
北大清华自主招生结果中，最受北大青睐的地方中学有哪些？	地方中学/nt
又是一年5.12，地震救援队来到学校教逃生	地震救援队/nt
印度是第二大海军吗？	第二大海军/nt
10所本科高校试点综合评价招生 9所驻鲁高校招1270人	驻鲁高校/nt
2016年~2017年贵阳高中录取分数线汇总！	贵阳高中/nt
2017皖西地区妇产科临床医学专题论坛圆满闭幕	皖西地区妇产科/nt
2018滁州学院调整部分专业教师招聘计划12人公告	滁州学院/nt
2018大学毕业生：国家电网工资高待遇好？这三种人却没机会报考！	大学/nt
2018大学毕业生：想要工资高？这5个含金量高的资格证不能错过！	大学/nt
2018大学专业薪酬排行榜 薪酬最高的专业排名 高考专业薪酬排行88	大学/nt
2018黄山市人民医院本专科招聘拟录用人员公示	黄山市人民医院/nt
2018级小学新生家长注意！明天，公办小学开始网上登记！	小学/nt
2018年海军阅舰式上亮相的哪件装备给你留下的印象最深？	海军/nt
2018年江南大学自主招生初审合格名单，有你吗？	江南大学/nt
2018年清华大学自主招生初审通过人数学校排名和各省人数	清华大学/nt
重磅｜2018年幼儿园报名时间节点和重要相关事项	幼儿园/nt
2018威海市中医院招聘初、中级岗位面试公告	威海市中医院/nt
2018西安事业单位招聘准考证打印开通	西安事业单位/nt
2018扬州小学排名新鲜出炉！快看看有没有你心仪的！	扬州小学/nt
2019建设银行秋季校园招聘报考流程	建设银行/nt
2019年中国工商银行总行本部校园招聘240人公告报名入口	中国工商银行总行/nt
10个“最好考”211大学！8成家长不知道！考名校不难！	大学/nt
2017年近百所本科院校及985/211大学在各省份最低录取分数汇总！	大学/nt
填报志愿：5所“非211”大学值得报考！不比211大学差！	大学/nt,5所/nt
3所“高考录取分最低”的211大学！	大学/nt
儿子刚考完估分500上军校能否?还有点近视，他说如成绩不好想复读，我不想他复读？	军校/nt
一句话楼市：北京有银行首房贷涨10%	北京有银行/nt
云南大学滇池学院2018年招聘公告	滇池学院/nt
为什么那么多企业用工商银行发工资？	多企业用工商银行/nt
俄罗斯海军的褐水战舰指的是什么？	俄罗斯海军/nt
美国加强航母编队开赴叙利亚，俄罗斯舰队为何迅速离港？	俄罗斯舰队/nt
第二次车臣战争中，俄罗斯空军取得了怎样的战果？	俄罗斯空军/nt
2018六安市直部分单位招聘额内人员递补资格复审通知	六安市直部分单位/nt
二本历史系学生想考北大世界史研究生，看了一些专业书和论文，需要准备什么可以继续二战？	二本历史系/nt
北大天才去二本学校当老师就是堕落？你对成功是不是有什么误解？	二本学校/nt
二本学校的大三学生该如何规划自己的未来？	二本学校/nt
向房地产公司交付的房屋认购金是否具有定金的性质？	房地产公司/nt
融创之争 两家房地产企业的商标纠纷	房地产企业/nt
在招聘中发现，很多非985学校计算机专业毕业的学生基础非常不扎实，这跟教学有关吗？	非985学校/nt
为什么菲律宾军队打击武装分子时候，伤亡比较大？	菲律宾军队/nt
新晃扶罗镇新寨小学：预防校园欺凌 构建和谐校园	扶罗镇新寨小学/nt
养老服务机构常见火灾隐患	服务机构/nt
武警福州支队举行防汛舟艇操作手演练	福州支队/nt
交警支队政委谢卫民赴肃南县交警大队督导工作	赴肃南县交警大队/nt
综合评价招生这么好，为何高三学生无奈？高一、高二学生的必看！	高二学生/nt
风雷行动平安南博｜治安整治进行时 昆明市公安局旅游支队、度假分局、高新分局、经开分局开展治安清查整治行动	高新分局/nt,昆明市公安局旅游支队/nt,经开分局/nt,度假分局/nt
2019工商银行总行校园招聘240人公告	工商银行总行/nt
高埗交警大队联合公安分局开展打击酒驾违法行动	公安分局/nt
“入读公办学校需做亲子鉴定”是个馊主意	公办学校/nt
入读公办学校需做亲子鉴定：提供虚假证明的人太多	公办学校/nt
入读公办学校需做亲子鉴定 嗯，要亲生的	公办学校/nt
入读公办学校需做亲子鉴定	公办学校/nt
幼升小，公立民办小学同时招生（公民同招），家长纠结什么？	公立民办小学/nt
松涛灌区管理分局开展2018年防汛抢险救灾实战演练	灌区管理分局/nt
宁和心理走进光明路小学开展“五防”安全教育公益课程侨星在行动	光明路小学/nt
广厦学院校园招聘会：5个岗位争一个毕业生	广厦学院/nt
广厦学院2018校园招聘会 700多家企业上演“抢人大战”	广厦学院/nt
北京大学国际医院完成首例医保异地就医跨省直接结算	国际医院/nt
印度国家自然历史博物馆发生火灾 整个建筑烧毁	国家自然历史博物馆/nt
哈尔滨市人民政府办公厅关于进一步加强房地产市场调控工作的通知	哈尔滨市人民政府办公厅/nt
雇佣军VS海军特战队：先拿火箭炮一阵乱轰，对方要奔溃了！	海军特战队/nt
传统车企进入出行领域 大众滴滴将成立合资公司	合资公司/nt
大众与滴滴出行组建合资公司，布局共享出行领域	合资公司/nt
神车快讯丨大众滴滴成立合资公司，特斯拉财务拉响警钟	合资公司/nt
重磅！和平河西小学初中学区规划、招生计划公布	河西小学初中/nt
Y877｜国海证券有限责任公司贺州建设中路证券营业部招聘简章	贺州建设中路证券营业部/nt,海证券有限责任公司/nt
重要！沪11区幼儿园招收人数+学费汇总	沪11区幼儿园/nt
以华为的技术去造战斗机可以吗，你怎么看？	华为/nt
滴滴配华为，给你意想不到的奢华出行	华为/nt
华为招聘的大学生中，哪些高校的比较多？	华为/nt
解放军用汽油桶子做的土制“飞雷”大显神威，黄维兵团全军覆没	黄维兵团/nt,黄维/nr
吉大慧谷学区房在售新盘及二手房报价吐血整理—吉大附属学校系列	吉大附属学校/nt
扎心！近期港城多家银行首套房贷利率上浮，部分银行暂停房贷！	银行/nt
交口交警大队利用农村“大喇叭”开展交通安全宣传	交口交警大队/nt
重磅！教育部公布2018高考报名人数：比去年增加35万，共975万！	教育部/nt
教育部公布，大学里“被抢疯”的4大专业，最后一个毕业工资最高	教育部/nt
近五千名留学生参加教育部留学服务中心主办招聘会	教育部留学服务中心/nt
招聘｜一家随时准备好带你去美国旅游的教育公司，约吗？	教育公司/nt
为什么现在教育培训机构成为暴利行业？	教育培训机构/nt
商品房业主维权诉讼需要京云专业维权律师团队	京云专业维权律师团队/nt
无需笔试，荆州市公安县事业单位招聘50人	荆州市公安县事业单位/nt
空军上校回忆10年前抗震救灾，至今保存着当年救灾指挥部的任务单	救灾指挥部/nt
「高考」市矿区中学举行2018届高考减压心理辅导活动	矿区中学/nt
宣汉昆池职业中学举办2018级新生心理健康教育讲座	昆池职业中学/nt
莱芜市公安局雪野分局打造安全景区助力旅游	莱芜市公安局雪野分局/nt
“特等功臣”隐姓埋名50余年，临终前只想再看看老部队	老部队/nt
龙岩体育运动学校开始人员招聘今年秋天即将招生开学	龙岩体育运动学校/nt
同在红魔步入巨星，但C罗状态如日中天，而同岁鲁尼欲养老大联盟	鲁尼欲养老大联盟/nt
跟着辉哥去旅行-栾城草莓基地采摘一日游	栾城草莓基地/nt
兴隆山旅游管理中心招聘工作人员名单新鲜出炉	旅游管理中心/nt
算命先生在毛坦厂中学门口摆摊，预测高考成绩，日挣200元	毛坦厂中学/nt
美国海军重建第二舰队	美国海军/nt
美国海军“黄貂鱼”无人加油机能在航母起降吗？	美国海军/nt
美国海军第一种正式使用宙斯盾的主战舰艇——提康德罗加级巡洋舰	美国海军/nt
美国科技公司中层员工薪酬对比：Facebook是亚马逊的8倍	美国科技公司/nt
海外见闻：美国医院特别看重就医感受	美国医院/nt
美国中学教师的月工资有多少？	美国中学/nt
历史上的今天：60年代北美航空XB—70“女武神”轰炸机首航	北美航空/nt
农民专业合作社联合下我国农产品区域品牌构建与运行机理	农民专业合作社/nt
2018清北自主招生初审名单公布，葡萄学院自主招生名师课程受追捧	葡萄学院/nt
五角大楼继续扩军：六大舰队即将变成七大舰队	七大舰队/nt
山东科技大学和青岛科技大学哪个学校更好些？	青岛科技大学/nt
全国高校首个青少年防灾减灾教育基地在四川大学成立	青少年防灾减灾教育基地/nt
全国高校首个青少年防灾减灾教育基地在四川大学揭牌成立	青少年防灾减灾教育基地/nt
全国青少年防灾减灾教育基地今日在四川大学揭牌	青少年防灾减灾教育基地/nt
曲陆大队“以雨为令”全面加强汛期交通安全应对管理	曲陆大队/nt
曲陆大队采取积极举措切实加强汛期道路交通管理	曲陆大队/nt
曲陆大队积极组织开展2016年国家防灾减灾日宣传活动	曲陆大队/nt
曲陆大队施“五严”之举应对新一轮强降雨天气下交通安全管理工作	曲陆大队/nt
三悦房产：城南高端楼盘正荣财富中心最优质住宅楼中楼出售	正荣财富中心/nt
套路式重组引发股价塌方，融钰集团越停牌越闪崩	融钰集团/nt
三甲医院在读研究生在临床给患者的看病过程	三甲医院/nt
2018山西太原广播电视大学招聘教职人员公告（15人）	山西太原广播电视大学/nt
2018陕西省考古研究院招聘公告（10人）	陕西省考古研究院/nt
科研人才｜清华-伯克利深圳学院、博士后招聘	深圳学院/nt
神木市公安局强力撑起校园安全伞	神木市公安局/nt
眉师附小隆重举行第32届艺术节开幕式	师附小/nt
抗日时期日本军队装备什么武器？这些武器的杀伤力大吗？	日本军队/nt
二战时日本军队的机枪为什么不用弹链而非要用铜板呢？	日本军队/nt
助力农产品品牌建设 山西晋食联盟专业委员会宣告成立	食联盟专业委员会/nt
曾经的世界第二海军——德国海军现役主力舰艇	世界第二海军/nt,德国海军/nt
本周六市直事业单位招聘笔试，这些你需要了解！	市直事业单位/nt
俄罗斯水下部队给的压力太大，法国决定再一艘梭子鱼级核潜艇！	水下部队/nt
情系子弟兵 宪法进军营	情系/nt
仪陇：四川德建房地产开发有限公司被税务行政处罚	四川德建房地产开发有限公司/nt
四川省高级人民法院招聘聘用制书记员51名	四川省高级人民法院/nt
皋亭山景区运营管理中心第一季度优秀员工公示	亭山景区运营管理中心/nt
血管通路再造：透析通路诊疗中心完成首次联合会诊	通路诊疗中心/nt
5.12大地震中，参与抗震救灾的卫星国家队！	卫星国家队/nt
号称史上最牛车，被汶川地震纪念馆收藏，现在却因销量不佳停产	汶川地震纪念馆/nt
宝沃汽车宣布成立北美研发中心 加码布局自动驾驶	北美研发中心/nt
行动起来，减轻身边的灾害风险：五里铺小学开展全国第十个防灾减灾安全教育课	五里铺小学/nt,五里铺小学/nt
开发商要求购房人自查买房资格 武汉房管局约谈房企	武汉房管局/nt
开发商要求购房人自查买房资格，武汉房管局约谈房企责令整改	武汉房管局/nt
2018年武汉科技大学团委机关部门及直属单位招聘公告	武汉科技大学团委机关/nt
沙特阿拉伯武装军队死对头伊朗会害怕吗	武装军队/nt
“新西安人”子女高考须回原籍？！西安市教育局最新回应……	西安市教育局/nt
重磅！“新西安人”子女高考须回原籍 西安市教育局发最新通知……	西安市教育局/nt
珍爱生命，远离溺水—淅川县上集镇一初中防溺水工作纪实	淅川县上集镇一初中/nt
麦苗洞察：大众滴滴合资，小鹏汽车G3开放预订	小鹏汽车/nt
小学初中报名请避开前三天高峰	小学初中/nt
越南公园里的“小诊所”，为人们提供糖尿病检测！	小诊所/nt
机会大把的，孝感市孝昌事业单位招聘明天开始报名啦	孝感市孝昌事业单位/nt
新干大队深入辖区人员密集场所 重拳出击排查火灾隐患	新干大队/nt
新干大队深入重点单位查隐患 全力保障冬春火灾形式稳定	新干大队/nt
「邀请函」计算机与信息工程学院2018届毕业生专场招聘会	信息工程学院/nt
雄安移动在市民服务中心完成5G远程自动驾驶行驶测试	雄安移动/nt,市民服务中心/nt
叙军打击叛军锋芒正盛，却传来坏消息	叙军/nt
叙军损失大了，六名防空指挥官被一锅端，因击落以军战机疑遭暗算	叙军/nt
叙军刚打掉该国F16, 之后叙七名士兵惨死，普京都不敢喊停！	叙军/nt
2017下半年宣城郎溪县事业单位招聘拟聘人员名单公示	宣城郎溪县事业单位/nt
雪豹突击队获国际特种兵比武亚军 叱咤国际的虎狼之师还有哪些？	雪豹突击队/nt
独家：烟台上市公司高管收入、薪酬福利大揭秘！看看哪家强	烟台上市公司/nt
罚学生赤脚跑点名潼南朝阳小学的家长，你的娃儿将来如何挑大梁！	小学/nt
县级医疗集团人才招聘大会5月26日举行	医疗集团/nt
北京协和医院麻醉科住院医师规培基地2017年招生简章	医师规培基地/nt
印度海军对俄罗斯米格-29K舰载机的表现满意吗？不怎么满意	印度海军/nt
有意思~印度海军放狠话：派50艘战舰24小时紧盯中国海军！	印度海军/nt,紧盯中国海军/nt
17岁被英国帝国理工学院录取，这个学生却说自己“被套路”了	英国帝国理工学院/nt
原创头条永泰法院全力抗击“莫兰蒂” 台风！	永泰法院/nt
玉泉大队“多强化” 筑牢汛期交通安全“防护墙”	玉泉大队/nt
有鱼有肉有牛奶：越南军队的伙食也不错噢	越南军队/nt
2018年云南省烟草公司临沧市公司招聘报名时间，报名条件	云南省烟草公司临沧市公司/nt
#消防实验室# 实验告诉你小电线如何引发火灾	消防实验室/nt
痘痕无踪，云南省中医皮肤病专科医院还您出众青春	云南省中医皮肤病专科医院/nt
兵哥、兵妹满满的都是爱！北部战区陆军某旅官兵积极参与无偿献血	战区陆军/nt
救命的房产，张家界旅游集团将卖掉12套房产增加利润	张家界旅游集团/nt
曾俊杰和他的珍禽养殖专业合作社：从提供珍禽产品到输出技术和品牌	曾俊杰/nr,珍禽养殖专业合作社/nt,珍禽产品/nt
校园招聘｜中国工商银行总行本部2019年招聘	中国工商银行总行/nt
第十一届中国国际国防电子展览会开幕	中国国际国防电子展览会/nt
中国海军所有舰艇在海上遇到它都得鸣笛致敬，航母也不例外！	中国海军/nt
中国海军这能力备受美国关注，也很畏惧，美媒：能和美军一较高下	中国海军/nt
中国海军的5种主力舰艇,为何摇身一变,都成为了海警船?	中国海军/nt
美国飞机想到中国基地附近偷看 结果被闪瞎眼	中国基地/nt
英媒称中国军队着手整治体重超标 超标官兵不能升迁	中国军队/nt
几百辆日军坦克冲锋 中国军队拿什么阻挡？41个步兵师拿命去挡	中国军队/nt
夏威夷火山喷发、地震 中国领事馆提醒：远离危险区域！	中国领事馆/nt
中国领事馆提醒远离夏威夷火山和地震高危区	中国领事馆/nt
中国领事馆提醒远离夏威夷火山和地震高危险区域	中国领事馆/nt
中国领事馆提醒远离夏威夷火山和地震危险区域	中国领事馆/nt
中国陆军新组建的集团军特战旅实战，来看看你能做到那几样？	中国陆军/nt
中国陆军、空军、海军、武警部队都有自己的军旗，你都知道吗？	中国陆军/nt
2018年中国上市公司董秘薪酬500强排行榜	中国上市公司/nt
参加约旦第十届“勇士竞赛”国际特种兵比武的中国武警代表队	中国武警代表队/nt
从中国医科大刚毕业的话，工资能有多少？	中国医科大/nt
尼泊尔驻华大使鲍德尔：感谢中国医疗救援队 分享地震救援经验	中国医疗救援队/nt
泪目！19年前，美5枚导弹从天而降，中国驻南联盟大使馆一片狼藉	中国驻南联盟大使馆/nt
中药企业寻求通过临床试验证明中药疗效	中药企业/nt
农业农村部种子管理局到我市督查国家救灾备荒种子储备情况	种子管理局/nt,种子管理局/nt
为什么足球国家队主帅的工资比俱乐部主帅的工资要低那么多？	足球国家队/nt
网易：不好意思杜蕾斯我要超车了滴……滴滴	
抚今怀昔，纪念5.12地震十周年	
上联：柳垂荷塘寻莲藕，如何对下联？	
上联：柳映池塘鱼上树，下联怎么对？	
上联：雪地梅花香傲骨，下联怎么对？	
大眼幼体如何选？河蟹苗养殖户如何管理苗塘？	
上联：墨泉，如何对下联？	
真的免费！官方组织一日游！十八条线路任君选！	
上联：容马驰尘杏花林，如何对下联？	
高蛋白饲料桑：生态猪肉、营养桑茶，绿色产业强强联合！	
凤凰网房产“百城读书会”主题活动盛启 点燃激情盛夏	
养殖户扛价，规模企业提价，屠企还能稳价收猪的日子估计不多了！	
上联:灯火辉煌万家乐。求下联？	
上联: 三国魏蜀吴，如何对下联？	
上联:诗友聚一堂，武文弄墨？	
上联：夏隐云天哭春姐，如何对下联？	
高标准农田建设：“小田”变“大田” 增产又增效	
对联：燕舞枇杷黄，求高手妙对	
上联：杨飘乱絮东西岸 求下联	
上联：星繁风幽催叶梦，下联你怎么对？	
夏末初秋心火易旺，高血压养生要牢记这9个字	
20张图告诉你，512广元景区人最多的景点，最堵的景点！	
各国领导人的薪资排行：普京只能垫底，安倍第三，第一高颜值！	
各国著名领导人的薪资排名，普京垫底，安倍第三，第一颜值特别高	
上联：佛卧白雪上雪白卧佛，下联怎么对？	
慢慢的很多人都爱自驾游，包里备好这住店好物，哪间酒店一样舒适	
多所双一流高校开抢生源：启动保研夏令营和推免生预申请	
19考研择校择专业-九大就业前景好的专业和十大保研率低好考院校	
学校无预演安全教育，学生直呼“身临其境”才懂安全技能重要性	
农民常说：人怕老来穷，禾怕寒露风，农民养老有多难？	
金蝉浑身都是宝，养殖容易效益好！	
老年人没驾照2万块钱买“路虎”“宝马”开，新鲜	
一台迟到了17年的近视手术，矫治高难度屈光回退手术	
热销50000的皮卡有何不同？帅铃T6全能驾驶评测	
房产高管薪酬大起底 万科郁亮年薪1189.9万仅排第二	
房地产高管薪酬大起底，万科郁亮年薪1189.9万	
房地产高管薪酬大起底，万科郁亮年薪1189.9万，仅排A股房企第二	
成人高考本科证书和奥鹏教育那些网络本科文凭一样吗？	
白水林皋慢城旅游景区正式跨入国家4A级行列	
武功山金顶景区大门进入？	
紧急通知：秦报融媒粉团祖山一日游日报名费大调整！	
端午节门前挂艾叶菖蒲，是什么道理？中医这样说	
从1小时内到第三个月，发生艾滋高危性行为该怎么办？	
上联：白蝶照影江心碎，如何对下联？	
拿到驾驶证，这些问题不注意，驾照基本等于白考！	
学生违反校纪校规，影响班风学风要不要惩戒，如何惩戒？	
学生违返校纪校规，影响班风学风要不要惩戒？如何惩戒？	
一名小学六年级班主任教师在班微信群里发表指责家长的言论，是否恰当？	
宝骏510可以加盟滴滴打车吗？	
宝骏360这款车的驾驶感受和空间舒适性怎样？	
造价低又实用，新农村2层独栋小别墅，养老的好去处！	
气滞血瘀，宫寒痛经，中医治疗体会和经验分享	
第一次驾驶老板的劳斯莱斯古思特，司机坦言既欣喜又害怕	
上联：归燕依旧住檐下；求下联	
上联：寒香有色雪纷纷，如何对下联？	
诗词欣赏：贾生	贾生/nr
滴滴，让安全伴您左右	
上联，抚琴求凰人安在；怎么对下联？	
轰6K、歼20、苏35海上巡航霸屏，不要忘了那款功勋战斗机	
上联：后羿射日，才得一场真诚爱。下联怎么对？	
高手才懂的11个自动档驾驶技巧 你会几个？	
容易毁掉健康的10宗罪？不要等到生病了才懂！	
上联：秀才有才乃文才，如何对下联？	
上联：自古才子多寂寞，如何对下联？	
为什么被交警查车时，车主经常要打电话呢？	
交警在查车的时候会摸你的车屁股是什么意思？你知道吗？	
驾校教练深夜酒驾带女学员回家，被查称大不了被扣12分！	
网约车的“痛”！滴滴悬赏100万缉凶到关闭平台自查一周	
果农种植葡萄近期常发病害，黑痘白粉病灰霉病要注意	
上联：常在花间走，如何对下联？	
这个驾照被称为：万能证，几乎所有车都能开！	
考完驾照后，你是怎么把车开熟练的？	
跟着车脉宝看看，你的车是交警喜欢查的类型吗？	
工资再低也要将这些车品配好了，让车子安全舒适的同时更显档次	
跟领导自驾游，才知道有钱人的车品，如此有品位！工资发了一定买	
「浅谈体」车神讲座之：远离滴滴，珍惜生命	
关于晨峰高血压你需要知道的	
农产品上行，移联网信模式成神助攻	
丑书究竟能不能称之为“书法”？	
老树着花无丑枝，如何对对联？	
解放军终于配发单兵帐篷，这种装具如果在淘宝订货不知道效果如何	
英朗小伙亲身经历：滴滴顺风车最短距离 这单接的爽	
为什么电竞选手的工资这么高，俱乐部不会亏损吗？	
医界痛失大医｜沉痛哀悼我国著名糖尿病学家向红丁教授	向红丁教授/nr
「政务」随机挑选乡镇，不预设路线……丁小强调研督导脱贫攻坚和乡村振兴！	丁小强/nr
今年大火的几款霸气钥匙扣，耐刮抗磨损，成功男士都爱	
现在果农都爱种这些果树，好养活而且一年两熟，果子能吃一年	
最娇嫩的鱼，传说被碰下鱼鳞就会死去，即使人工养殖都达几千一斤	
解读：为什么交警都戴“白手套”？原来有这2大作用！	
钻石都能在实验室“养殖”了？看来人手一颗不是梦！	
如果空姐和滴滴司机都能这样做，那么这场悲剧就可以避免！	
巴基斯坦选择韩国火炮？其实都是穷惹的	
农夫的皮卡已开六十年，交警看到都问这是哪个牌子？	
这些身边的火灾案例告诉你，用电用气稍有不慎，都易引发家庭火灾 ……	
上联：花下独赏月，怎么对下联？	
房产调控许多房企都破产了为何房价还是居高不下？	
房地产发生了什么？房企要求员工取消所有休假加班冲业绩！	
上联：风惊蝶恋花，下联怎么对？	
上联：风卷庭前落花廊，如何对下联？	
上联：和谐平安福万家；如何接下联？	
房地产大局已定，买房尚有3大疑问，刚需不淡定了！	
限购取消了刚需还买啥房？租房真的是无房者的最好选择吗？	
炒房者卖不掉，刚需者买不起，18年该不该买房？	
印度刚又出事了，这一次闹笑话的是空军！	
面对即将开学的流感高发季：如何做到有效预防？	
房价高全怪炒房客 炒房客：不炒房我们炒什么？	
上联：痴心父母古来多，下联如何对？	
从科一到科四关关通，让你轻松拿驾照	
「招聘公告」龟峰景区招聘专、兼职导游（讲解员）的公告	
上联：骑青牛，过函谷，老子姓李，如何对下联？	
隐形“猛禽”再加量 韩美启动联合军演	
韩美启动空中作战演习 首次出动8架F-22战机	
上联：一条楚河分汉界；求下联	
书法家的字刻成石碑，为何会不走样？	
网约车丨没有安全，何谈便捷	
如何学米体书法？	
生猪价格稳定半个月了，为何有的养殖户却说：希望猪价再跌一跌？	
殷秀峰详解大飞机四大疑问：为何造？难在哪？国产化？安全吗？	
上联：春风得意花千里丨下联：该如何对？	
上联：人生如戏花如梦，如何对下联？	
对联：花易折，如何对下联？	
上联：花有重开日，如何对下联？	
女子3800出租江景房，被改成10间，二房东：找几个人弄弄你	
上联：心到解万愁，如何对下联？	
上联：柳着金妆闲钓水，如何对下联？	
上联：井小却可吞日月，下联如何对？	
上联：千古人物浪淘尽。求下联？	
下联：人老多忧百事忙；求上联	
房产中介打响平台升级战 平台整合力成未来撒手锏	
别只关注航母海试，055型大舰3连喜也要了解一下	
7种“小痛”其实是大病前兆！耽误了连医生都救不了你	
为什么有的人没练过书法也能写得一手好字？	
上联是：鹊鸣林中难见影，如何对下联？	
龙猫专业繁殖养殖前景怎么样？具体注意问题有哪些？	
国外：2018年马自达CX-5首次驾驶评论！	
上联：满衣清泪清平乐，怎么对下联？	
上联：猫生猫，鼠生鼠，猫鼠同窝，请对下联？	
上联：摘梅惊雪落，如何对下联？	
现实中发生枪战时，能否用汽车门来挡子弹？	
养殖户门如何警惕夏天热应激？	
上联：梦里水边情，回味绵长，下联怎么对？	
听闻洛杉矶拟开征“暴雨税”，我给米国人民贡献几个诗歌支招	
立足于教育培训行业，觅优师要让教师成长与招聘变得更简单	
大豆苗后除草剂怎么样使用效果好？	
怎么打除草剂才能不伤苗又除草？	
2018年房价“明降暗涨”，八成房奴难逃这5大厄运	
上联:一轮明月亮天下，下联怎么对？	
上联：我欠明月诗百首，如何对下联？	
上联：劝君莫打三春鸟，下联怎么对？	
上联: 莫问风景在何处。下联怎么对？	
莫再让顺风车变成陌陌！	
上联：春风沐浴花争艳，怎么对下联？	
【老兵心声 】致敬那本压箱底的「退伍证」！	
驾照拿了几年，没开过车，买车那会竟会有这样的顾虑？	
有些战斗机使用复合材料，那战损后的碳纤维材料该如何处理？	
二代“猪倌”念活环保养猪经	
二代“猪倌”念活环保养猪经 年产值达300万元	
“宁当月光族，不做守房奴”？90后的租房思维能否“普及”？	
我的天，嫁接果苗真是牛犇！高产耐活年收千斤，邻居看了抢着种	
发工资一定要买的八款车品，一款比一款牛犇，轻松解决尴尬	
上联：老子骑牛西去；求下联	
歼20机头+苏57机身+F22喷口？欧洲第六代战机曝光	
2018年俄罗斯世界杯哪个国家队教练工资最高？跟里皮比起来呢？	
舰艇的颜色涂装有标准吗，为什么会出现补漆后不一致的情况？	
如果驾照不考了，教的钱会退吗？	
下联：袅袅白雾知秋深，怎么对上联？	
#秋招#在择业招聘会中面对985/211名校毕业生竞争者，海归是否还吃香？	
癌症患者虚弱乏力怎么办？首选十全大补汤	
坚持每日一练，教师招聘得高分，10道题你全对了么？	
教师招聘想考高分？你得坚持每日一练！10道题全对可不容易……	
驻叙俄军全靠机器人减少伤亡，乌兰6搭配乌兰9，阅兵武器都参过战	
上联：容易容已易，如何对下联？	
上联：一粒沙藏世界；求下联	
沙坡头景区又出劲爆政策，将延续“五一”火爆旅游热潮！	
上联：山再高也在人脚下；如何接下联？	
这个行业人少钱多，人均月薪6万8！有人最高工资达……	
以色列对叙军事基地和军火库射导 部分导弹击中目标	
快递上市企业薪资起底：顺丰高管分红最壕 申通员工降薪最狠	
快递薪资大起底：顺丰高管分红最壕 申通员工降薪最狠！	
顺丰高管分红最壕，申通降薪最狠，各家快递薪资差异有多大？	
假如台风在海平面刚生成时就将导弹丢进风眼中心会怎样？	
士兵突击里的史今班长，我的团长我的团里的烦啦	史今/nr
老农嫁接一树多果，有义务造“嫁接神器”，小孩子都会操作	
老农嫁接一树多果，有了这个嫁接神器，没文化的人也能操作	
对联上联：春风吹开花千树，树树争春。求下联？	
限价房销售新规征求意见 “双防双保”意在扼杀“炒房”	
暴雨天开“双闪”还是“雾灯”？用错了就要罚款！	
《在水那方》之 第一次实弹轰炸	
上联：天寒地冻，水无两点不成冰。下联怎么对？	
用数据告诉你 苏城购房者选什么样的房子？	
下联：画眉展歌喉，花肥凭添香。上联怎么对？	
买完房，开发商却推迟办理房产证，小心其中有猫腻	
下联：万户山城飘炊烟，如何对上联？	
上联：万家同贴一福字，如何对下联？	
上联：万里寒光生积雪；求下联	
上联：万里河山万里云，如何对下联？	
上联：万里江山万里画,下联怎么对？	
上联：万龙聚首，下联怎么接？	
汪拥军：积极应对新高考改革要求，为学生发展提供保证	
新威朗GS，车型外观完美，智能识别驾驶、6种照明模式！	
木水土前皆叩首，唯逢金字不折腰「原创诗词」	
中医思维原创 黄芪，少阳之气的王者，温阳的虎将！	
文山交警联合多部门强化汛期高速公路交通安全隐患排查集中整治工	
诗词欣赏：秋日登吴公台上寺远眺	
我们常说“相由心生”从中医角度解读脾虚，面黄	
现代战机为什么不安装一个向后发射的机枪来对付来袭导弹？	
今后，小散养猪还有前途吗？	小散/nr
上联:金鸡报晓画竹叶，如何对下联？	
上联：雪落谁家须有旨，下联怎么对？	
书法用纸是生宣好还是熟宣好？	
上联：春风执笔谁研墨，怎么对下联？	
「养殖」羊采食量下降？不要轻视	
甲有5套房不上班靠收房租生活，乙有1套房上班，丙无房卖菜	
甲有5套房，不上班，靠收房租生活；乙有1套房，上班赚工资……	
上联，春花有影添风彩。下联？	
余再新：新型抗凝药物治疗静脉血栓栓塞症的临床应用	
上联：月栖水里问鱼好，下联怎么对？	
什么鱼可在温室养殖？	
绿色养殖 打生态鱼之牌	
吴玉如书法：文人笔墨，小楷写得精致，不服不行	吴玉如/nr
种植户雇工种辣椒，工钱前几天每小时6元，现在10元也难雇到人	
你问我答：如何继承原号｜补办驾驶证｜取消预约	
房地产大数据服务商「云房数据」获2000万元融资	
空军运—20首秀空降空投	
书法想要写得好，天赋和勤学苦练各占多大成分？	
郑医·情暖｜教育护士：让患者满意，就是我的价值！	
为什么盆骨煮熟了，还能植回患者体内	
上联：疏通竹径闲迎月，如何对下联？	
上联:竹是无心树，如何对下联？	
上联：竹雨松风琴韵，下联怎么对？	
厄瓜多尔为61只英雄犬举办退休典礼，地震搜救中勇敢无畏，祝好！	
种植管理：六项举措确保农作物长出壮根	
「心 声」从机制到临床，一起认识左束支阻滞！	
还没到520，老公发工资就给我车上装了这些车品，简直太好用了	
小学生成迷于游戏怎么办？六大妙招教家长如何教育？	
责任扛肩上 陕州举行学生成人礼	
继广场舞之后，养老产业又成新风口？	
后院着火！刚晋级东决骑士队就曝出内部问题，可累坏詹姆斯了	
养猪户老王每个星期都会往猪圈里面扔沙子，一问才知道原因！	
中医里的“阳虚”和“阴虚”两个都亏怎么办？	
荣立二等功、三等功各一次，这个坦克手“疯”起来，连自己都怕	
90后土豪婚礼，加长悍马做婚车，连交警都为其开路	
今年的“惠农补贴”都有哪几种？来看看你漏掉了什么补贴	
徽艺小镇瞄准非遗4A级景区	
上联：风舞杨花迷人眼，怎么对下联？	
上联：风萧雨寒飘窗叶；求下联？	
上联：风中倦鸟思春暖，如何对下联？	
上联：枫示金叶炫富贵，下联如何对？	
张福先：静脉血栓栓塞诊治过程中的困惑与思考	
雷雨高发季，闪电来了怎么办？	
诗词欣赏：与高适薛据登慈恩寺浮图	薛据/nr,高适/nr
雪莲果是水果也是糖尿病人的伴侣	
上联：母爱似海比海深，如何对下联？	
韩美今启动“超级雷霆”联合军演，8架F22战机参演	
农村最经典农事顺口溜，种地不上粪，等于瞎胡混！句句准的可怕！	
上联：暖风徐徐推花醒，下联是什么？	
上联：黄鹤楼头揽胜景，怎么对下联？	
如何看待“女教师打了学生一巴掌，学生立马回打一巴掌”这件事？	
嵇境雷——新时代最具收藏价值的书画名家作品展	
上联：金龙盘玉柱，怎么对下联？	
幸福踏青季 京北一日游——春江水暖鸭先知，一起去看野鸭湖吧	
李炯峰书法杂谈系列（三）启明整理	李炯峰/nr
热点新闻｜田野：心脏预防与康复为患者带来福音	
冲刺高考：安慰“没考好”的孩子，不要只会说“没事、没事！”	
上联：莫言老舍老，如何对下联？	
考驾照：大家说说你都是在科目几挂的？说说学车的乐子	
上联是：秋残雨冷叶飘落，下联怎么对？	
上联:少小凌云辛历社稷今有幸，如何对下联？	
上联：柳随风动不争东西南北；怎么对下联？	
上联：苦雨虐荷，岸边老柳长垂泪；如何对下联？	
916爱旅行丨跟随FM91.6主持人青洋鲁地自驾游！	
安想珍毛体书法精品向马克思200周年华诞献礼	
上联：雪映窗前梅花庵，求教下联？	
上联：风晒夜霑梅亦香，下联怎么对？	
以梦为马，不负韶华｜距高考30天——Linda呈上高考小贴士	
驾照车辆齐脱审，莫怪交警不轻罚	
2018高考备战进入倒计时，家长应注意那几点帮助孩子	
上联：大雁鸿鸣向南飞，如何对下联？	
台湾名中医彭奕竣：关于糖尿病的事实、真相与骗局	
秀英“线上线下”齐发力 助力贫困户“微互动”拓宽农产品销路	
2018最受清北自招招生青睐500强高中：陕西10所高中！103人入围！	
奇迹！经历几十次强震，600年比萨斜塔仍不倒 专家：土壤是关键	
“兵王”乔欣安，当兵30年，他的退休仪式为何令人动容！	乔欣安/nr
胡秋萍书法：在创新的过程中，迷失方向了吗	胡秋萍/nr
付荣基山水作品装饰收藏皆可	
上联：东南西北有山，山青青，求下联？	
INFINITE金圣圭确定5月14日入伍 将进入这个师团	
果树全年该施几次肥，什么时候施肥合适，施什么肥好？	
楷书《石涧记》	
男子在查看洪水造成林木受损情况时　发现了眼前这一幕	
精雕细琢完善提升全力争创5A级景区 胡世忠在吉州窑景区调研	
为民营企业招才引智 2018年“双创”招聘会在兰举办	
田觅密为您提供绿色健康农产品	
人民日报评万科高租金，透露公寓新趋势，别将来连租房都租不起！	
文山交警“五项措施”全力做好强降雨天气交通应急管理工作	
舰艇资料库 之 忠武公李舜臣级驱逐舰（韩国）	
立夏夏未至蝉声声，如何对上联？	
阿富汗北部兴都库什地区发生6.5级地震	
上联：夜里销魂、醉取花香来续酒。怎么对下联？	
“防重严快稳”！教育部长陈宝生提出平安高考“5字诀”	
75军某旅主题教育官兵唱主角 用兵言兵语讲大道理	
英公布7年报告称伊战出兵严重失误，政坛地震！布莱尔或永失公职	
诗词美文欣赏——音悦春风	
汜水、英峪、鲨鱼沟、站街沿黄快速路一日游	
“逃离鹰爸”背后的教育实验：到底谁在撒谎？	
学车考驾照不在于练车少，就怕学员不动脑	
贞丰长田供电所开展春耕安全用电检查	
招行获10名高管增持 A 股，行长田惠宇花一年薪酬“支持”11万股	田惠宇/nr
大出行添新丁 凌动智行网约车或今夏落地	
手痒，就来点！现金大奖周周有，景区门票天天抽！	
战乱的阿富汗地区，枪支可随意买卖，AK47价格约500人民币	
阿富汗、塔吉克斯坦边境地区发生6.2级地震	
阿富汗、塔吉克斯坦边境地区附近发生6.8级左右地震	
阿富汗北部发生6.2级强震 已致两名小孩受伤	
阿富汗边境地区发生6.8级左右地震	
阿富汗发生6.4级地震	
阿富汗发生6.4级地震 震源深度120千米	
阿富汗发生6.5级地震 暂无人员伤亡报告	
阿富汗塔吉克斯坦边境地区发生6.8级左右地震	
巴基斯坦与阿富汗边境5.1级地震 暂无伤亡报告	
警告！6.2级地震袭击了阿富汗和塔吉克斯坦的边界，使房屋晃动	
正式测定：阿富汗发生6.4级地震 震源深度120千米	
阿富汗发生2起恐怖袭击并受地震波及 注意安全风险	
阿根廷大豆产量受暴雨冲击 财政收入受影响	
实拍各国空姐：阿拉伯的最漂亮，美国是股泥石流	
“阿帕奇”武装直升机的威力有多大？	
AK-47步枪能否击落阿帕奇武装直升机？	
印度阿琼坦克的发动机是国产的吗？	
清洁阿姨工资只有2000多，为何很多有钱人却还要去干这个工作？	
爱奇艺房产来了！娱乐全触点新营销助力精准卖好房！	
爱奇艺校园招聘过滤河南人，真是极其低俗且极度影响企业形象	
现代中医食疗创新养老模式、爱雪康助力养老健康	
火箭即使买断或者裁掉安德森都没有薪金空间了吗？	
工资再低也不要吝啬，车内贴上这个“万能封”，跑再久也安静舒适	
土耳其 安卡拉暴雨致洪水 多人受伤	
安康旬阳交警：多措并举开展道路交通安全攻坚战宣传活动	
空姐遇害 滴滴和美国网约车安全措施差距在哪？	
驾驶安全有保障！汽车安全带如何更换？	
出租车网约车后排安全带形同虚设 死亡概率恐增5倍	
夏季气温高，糖尿病患者如何安然度夏！一文读懂	
最大火黑竟是他！直言勇士5场干翻火箭 奥尼尔：又想亲驴屁股？	
“鬼才”数学老师：报什么奥数班，背熟这18张图，小学6年都不愁	
种红薯不补钾，施肥再多也白搭！怎样才高产？试试这些好办法！	
中医带你了解，白发与身体的关系	
上联：白雪白发白头翁，如何对下联？	
为什么军队中的新兵，千万不要扔白磷弹？看完大开眼界	
白石老人竟然是这样才开始写书法的？	
2018年“媒说白石山”系列活动暨新品发布会在白石山景区举行	
白塔寺景区工人植树增绿	
「图」白塔寺景区工人植树增绿	
上联:白雪无情埋菊花，求下联？	
白银交警曝光一批违法未处理车辆，有你吗？	
上联：土中生白玉，如何对下联？	
德国柏林的历史城市列车驾驶模拟器驾驶列车	
井中取宝，请出对联？	
提前给伤者垫付医疗费，给滴滴“关怀宝”点个赞	
湿气重是宝宝反复生病的重要原因，宝宝祛湿你做对了吗？	
农村这种野菜，是乡下人的宝贝，可对付心脑血管疾病	
美国一种士兵被视为宝贝疙瘩，有专门保镖，战场上不能被俘只能死	
扩散！乘网约车安全宝典！	
单身女士深夜乘坐网约车安全宝典	
28架战机夜袭叙利亚，发射70枚导弹，俄军提供宝贵情报	
上联：宝马拉宝马，如何对下联？	
宝马广告被指“提倡危险驾驶”	
宝马X1三缸机，抖？不抖？听听车主的驾驶感受	
宝马3系，驾驶它是一种什么样的体验，看车主是怎么说的	
世界上唯一禁止装空调的国家，老百姓半年工资能买奔驰宝马	
宝马M5雷霆版 纯粹的驾驶机器/3.3秒即可破百	
上联：巧驾宝马追明月，下联该如何对呢？	
宝沃成立北美研发中心，加码自动驾驶	
上联：红楼藏宝玉，下联怎么对？	
上联：红楼梦宝玉，求下联：……	
公积金出台新政策，为刚需用公积金买房保驾护航！	
新融农牧：为中小养殖企业融资保驾护航	
胰岛素泵为糖尿病手术患者保驾护航	
六点白内障的保健常识	
抑郁症 的中医穴位保健方法	
颈椎病患者的科学锻炼和日常保健	
中医小儿推拿保健师：舌有花剥苔，名叫“地图舌”	
保时捷驾驶人遇交警嚎啕大哭，是为何？	
电影《生化危机》里的暴君能硬接125口径的坦克主炮吗？	
宝宝近视 要怎么治疗？-鱼乐贝贝	
教师招聘考试你需要知道的：奥苏贝尔的有意义学习	
勇士薪金情况如何？本赛季几位球员合同到期？	
比萨斜塔为何历经数次强震不倒？谜底揭开了	
比亚迪宋MAX可以跑滴滴吗？	
对联：江南莲叶无穷碧，如何对下联？	
原创「诗词」晨曦披衣观旭日，碧波璀璨霞满天	
下联：白雾动情抱碧峰。怎么对上联？	
房地产四大龙头企业销售榜单出来了，碧桂园强势登顶	
碧桂园是如何通过两次变革开拓房地产市场，轻松完成上亿销售？	
等俺有了钱，就在碧桂园整个房子养猪	
三农日报｜2018农业生产获财政支持；碧桂园招聘养猪专家	
地产跨界新玩法，碧桂园招聘养猪专家，跨界做农业！	
「碧桂园信鸿铜雀台」家门口的国家风景区？	
上联：风吹碧江荡天地，下联怎么对？	
上联：碧水荷塘花正艳，怎么对下联？	
上联：水如碧玉山如黛，下联怎么对？	
农民伯伯请注意！各类病害及用药（二）	
英超球队工资性价比榜单：伯恩利居首，曼城仅排11名	
英超球员工资性价比榜单：伯恩利居首，曼城排中游	
房价已见顶！炒房将是危险的博傻游戏	
吉利博瑞GE科技配置曝光 L2级别智能驾驶	
博瑞GE搭“逆天”配置 含L2级自动驾驶技术	
搭载L2级别自动驾驶技术 博瑞GE科技配置曝光	
为什么狙击手的狙击步枪上缠满了布？	
上联：谁在天上布风雨，胆大包天，如何对下联？	
《布赫诗词》书法展笔会在呼举行	
上联：桌上苍蝇布阵。如何对下联？	
上联:大漠苍狼鹰击天，求下联？	
二手房如何查房龄？盘点二手房房龄查询方法	
活用大小柴胡汤！「跟己安先生学中医」	
肛肠科医生推荐：痔疮患者需常喝这三种药茶	
「永平科普」常见病防治—高血压！	
空姐遇害促使顺风车大整改，滴滴应防止司机私下交易	
「读心有术」068期：陈旧心梗患者为什么突发晕厥？	
上联：撕心裂肺《陈情表》，如何对下联？	
晨起看几则重要的昆明教育资讯吧	
世界第一！成飞曝光新机型，将同歼20搭档！	
在叙利亚出现的俄军成建制机器人部队是怎样的状态？	
2018年，这三种工作很缺人，工资与勤劳成正比！	
你所在的城市，房价与你的工资成正比吗？	
上联：一池绿水映明月；求下联	
上联：一池芍药胜牡丹，如何对下联？	
初中生被老师批评后离家出走 家长闹翻学校 学校：该老师停职	
春耕梯田如画卷	
春耕人倍忙 四野好风光	
补贴17亿元全力保春耕	
春耕备肥，当心着了假化肥的道！	
春耕早就开始了，一直想买东风904拖拉机，到底怎样啊？	
昨天小雨太随意，像样的雨再等4、5天——春耕期间天气预报	
上联：春光明媚神州万里披锦绣，下联怎么对？	
上联，春光明媚神州万里披锦绣，下联怎么对？	
上联：春江花开月明夜，下联怎么对？	
「春雷行动」无证驾驶摩托车危害大，必须实名曝光他！	
春天里，哮喘患者除了尽量待在屋子里，还要注意这几点	
春夏秋冬，不同的季节应该种什么农作物？	
上联：春夏秋冬看世界，如何对下联？	
上联：春夏秋冬又过年，如何对下联？	
上联：春夏秋冬，完美，下联怎么对？	
上联：怎忘今生慈母爱，怎么对下联？	
上联是：翠柏古松千载寿，如何对下联？	
4A级旅游景区，翠华山的太乙池这样的风景有多美，是不是值得一看	
5.12剑门关景区、翠云廊景区免费啦	
感恩全国人民无私援建 5·12当天剑门关、翠云廊景区免费对外开放	
3477家上市公司高管去年薪酬大比拼 金融业、房地产业最壕	
古巴导弹危机——大胡子被坑了	
精彩抢先看！今年文博会大鹏分会场十分吸睛！	
不要小瞧越南的水平 已经能够独立大修苏-27战机	
果农种植大樱桃近期果园管理，更新观念科学操作！	
杀菌剂代森锰锌，农民的好伙伴！聊聊嘧啶类除草剂主要特性	
叙军全线出击！戴尔祖尔收复战打响！叛军一溃千里	
近视眼戴眼镜会让度数越来越深，是真的吗？	
600度近视的我，一天不戴眼镜感觉整个世界都不好了	
上联：丹凤朝阳，如何对下联？	
「对联48」岁月单双号，请您对句	
上班8小时单休工资8000和辞职开店，哪个好？	
一辆道奇，一辆捷豹，三台旋挖机，可他就是没钱给工人发工资	
二战时德军是怎么分辨哪些是犹太人的？	
二战德军和美军的通信技术的差距如此之大	
二战德军为何采用闪电战？德军为何适合闪电战呢？	
二战德军经典装备，这国精锐士兵使用时，却胸骨尽断大量阵亡	
二战珍贵影像资料，二战德军装甲部队战场原声视频，一炮一个！	
非洲战场表现勇猛的德军，作战环境这样困难，一天只得到半杯水	
1942年德军的夏季攻势的目标到底是斯大林格勒还是高加索地区？	
莫斯科之战，德军为何不空投棉衣？	
为家乡打call！“我心目中最美丽的德清A级景区村”评选开始啦！	
迪士尼“半日游”：我走过的坑，希望你不要再入	
美国洛杉矶迪士尼乐园Disneyland一日游攻略	
上联：穷山恶水出刁民，如何对下联？	
农机大市场中，1504东方红的补后价是多少？	
东胜招聘130名教师！专科及以上，应届往届均可报，部分岗位不限制专业！	
新品推荐——陶氏杜邦新型杀虫剂“佰靓珑”上市	
竹海明珠景区杜鹃花正艳，小伙伴踏春去吧！	
做到"七不 一断" 杜绝学校火患	
勇士球员本赛季薪金情况，库里第一，杜兰特第二，千万合同有五人	
战火重燃！美“杜鲁门”航母群正式参战，俄集结3万大军强势反击！	
房产中介才是段子手界的王者，微商都要甘拜下风	
司机被段子坑惨了！当交警面喝半瓶酒被判两个月	
「诗词」一笑离凡尘《时间简史》	
大隐书院 上联：了悟凡尘知因果，下联谁来对？	
从这现场战斗不同结局来看，《亮剑》其实也属于“抗战神剧”范畴	
中医世家经验方二	
方放的书法怎么样？	方放/nr
二手房惨淡，一手房疯抢，多空论断百出，买房人该如何对待？	
上联：霜染红枫胜画图，求下联？	
数十艘军舰封锁俄罗斯后院，普京：72小时全部撤离，否则全部击毁	
Wayom计划今年在凤凰城推出自动驾驶汽车打车服务	
凤林答你问｜聊聊高血压那点事	
扶桑花卉的施肥与病虫害防治，以及扶桑的繁殖方法，和用途！	
6月30日前福建人游览23家宁夏景区免门票	
好消息：福建人身份证又升值！这些5A景区免费玩，超多地方半价……	
买房是一次性付清划算，还是通过房贷慢慢付清呢？	
买房是一次性付清好，还是通过房贷慢慢付清好呢？	
下联是：汗水浇开富贵花，如何对上联？	
“富婆天后”容祖儿砸2亿买豪宅送母亲，12处房产身家已超4亿	
富婆招男司机开500万豪车，月薪10万，只有四个要求却无人敢应聘	
富士康普通工人的工资有多少？	
耕地可以盖房吗？为什么农村人到处都可以盖房子？	
推出高抗病甘蓝品种，先正达给种植户带来了福音！	
俄军高超音速导弹已全服役：十多架米格31战机随时待命	
不明飞行物？外星人？不好意思，东风-17高超音速导弹了解一下！	
这景区旅游最高峰时，年收益高达300亿	
待遇高达6.7万，这个招聘你不能错过！	
00后熬夜人群高达45.7%，睡眠过少死亡率翻倍	
当海滨2日游遇见森林高尔夫 这个五月不一样！	
北京儿童医院迎暑期就诊高峰，Get权威就诊攻略	
冷战的开始高丽街争端	
中华书法高清法帖欣赏——《空海风信贴》	
中华书法高清法帖——先锋本石鼓文04	
史上最全铁皮石斛病虫害高清图谱！	
作为一名高三学生，人生的起点到底重不重要？	
作为高三考生，在填志愿时，先选专业还是先选学校？	
「高三家长注意啦！」倒计时一个月 今年高考有这些新特点！	
2018年高考前20天，语文还能做什么？给高三的孩子看看	
备战高考，高三学生复习资料堆满过道	
越临近考试，越学不进去？探究原因，不是高三就来得及！	
不要假装很努力，因为结果不会陪你演戏——致正在奋战的高三考生	
从高三走向高考，家长该充当什么角色？6种沟通要诀必须掌握	
学校负债邀请新老校友捐款，高三家长投诉：每名学生被要求1000元起捐	
医患故事：肺部结核病，高三学生重在预防和早发现	
揭秘房产中介高薪的背后	
加大高薪护士罢工调涨薪资太无理？	
「毕业季来临」高中毕业的你必须抓紧时间申请名校！	
上联：戈壁无水莎草绿，下联如何对？	
「华晨格林水岸」纳入荷塘小学本部招生范围	
这是一支默默无闻而功勋卓著的部队	
德国“STORZ”宫腹腔镜微创技术在临床上的应用	
什么样的病人适合做造影，通水，宫腔镜？	
武警拿着工资帮孤儿交了多年学费部队竟没人知道 女武警来了	
下联古渡夕阳渔家火，上联怎么对？	
世界上最古老的海岸炮景区，有去过吗？	
99句古诗词：你走过几座诗词中的“桥”？	
上联：齐鲁大地古韵长，下联怎么对？	
时间谷文化创意港分会场将亮相文博会	
谷歌自动驾驶汽车在美遭遇车祸 驾驶员轻伤	
摇号买房是怎么了！购房者和置业顾问竟然都这么抱怨	
首佳顾问标准及成果展示之《中估房地产评估数据标准》	
关东军到底是一只怎样的军队？	
首长关怀—总队参加东北三省石油化工火灾跨区域实战演练纪实之四	
律师专业解答养殖拆迁补偿问题，粤、桂、琼等多地开启新一轮禁养	
下联：风吹桂花十里香；求上联	
哈铁插秧专列连开19年运送“稻客”160万	
哈铁插秧专列助力160万“稻客”走向致富路	
哈铁插秧专列连续开行19年 助力160万“稻客”走向致富路	
哈铁开出今春“插秧专列” 开行19年运送“插秧客”超160万人次	
5月9日最新教师招聘公告汇总（含特岗）	
上联：寒山明月过江去，怎么对下联？	
“狗嘴何曾吐象牙？”请赐上联？	
原创诗词｜月残梦醒香魂逝，璀璨星光何处寻	
热点文章｜何胜虎：缺血性心力衰竭的诊治	
农产品价格跌跌不休，很多人还是吃不起的现象，何时能到尽头！	
问世超10年！2020年首飞？空天飞机在军事上到底有何用途？	
一个博士把中医说的什么都不是，我给中西医和稀泥	
F-35绰号黑豹？官方称呼遭美军飞行员嫌弃，这决不是第一次	
波兰购现役黑杰克无人机，金额达1千万美元	
重磅！网约车司机无证上岗或被直接列入黑名单	
再敢拖欠农民工工资，拉入“黑名单”不得翻身！	
交房租还是还网贷？“黑中介”捆绑网贷平台设“套”	
二手房交易这几点要注意 教你避开黑中介的那些“坑”！	
恒大官宣：昨天亚冠比赛，就球衣事件，总经理等五人降工资处分	
以书法为媒弘扬传统文化	
上联：网红爱作秀，下联怎么对？	
红谷滩新区教师招聘6月2日笔试	
上联：千朵红莲三尺水，下联怎么对？	
下联：千年红梅发新芽；求上联	
上联：喜看红梅多结子，下联怎么对？	
上联：大雪纷飞，一树红梅争傲骨；下联怎么对？	
下联：雪映红梅岁月寒，上联怎么对？	
上联：红娘子半夏当归并蒂莲，如何对下联？	
红旗-16防空导弹到底是不是国产，俄罗斯专家说出实情	
红旗岭22万亩水稻插秧工作稳步展开	
红外热像仪可使自动驾驶汽车更安全	
上联：院中红杏多浇水，下联怎么对？	
上联：芳华红颜弹指老，下联？	
上联：踏雪归来红颜老，如何对下联？	
上联：春尽红颜老，老有所依。如何对下联？	
上联：雪落梅梢，愿与红颜同白首，如何对下联？	
如果在洪崖洞景区，碰到穿着怪异的“演员”，那你就要小心了！	
村民非常希望洪水袭来，因为他们可以趁机淘金，趁机“发财”	
洪水袭击村庄，水里大鱼吃了一些村民，老道长说大鱼吃的是坏人	
洪水淹没村庄后，水里出现了一些大鱼，大鱼见到人就吃	
人的生命似洪水在奔流，不遇着岛屿、暗礁，难以激起美丽的浪花	
印度为什么容易发洪水？	
房贷洪水推高房价，银行到底怎么想？	
洪水过后猪场该怎么做？	
洪水无情，千万余亩农作物受灾，这样补救才能最大限度降低损失	
在看洪水时，你在想什么	
上联: 残阳不语逐鸿雁，如何对下联？	
知耻后勇！大使馆被炸19年了，幽灵轰炸机依然逍遥法外	
首艘国产航母将命名！这个名字呼声最高！国人一片欢呼	
我国航母将会叫什么名字，呼声最高却是它，看后没人会反对	
呼童扫雪烹香茶，对联？	
胡蜂养殖技术学会增加收益增加知识	
新规定：喝酒没开车也算酒驾，特别是第一条，简直胡闹！	
花丁：糖尿病人在职场	
花丁：糖尿病患者总是喊腰疼，真的是肾病吗？	
花丁专栏：这种夏日粥品，糖尿病人千万别错过	
上联:石榴花蕾点点红，下联怎么对？	
上联：花香逗得风留步，下联如何对？	
上联：少年怀才轻疏狂，下联怎么对？	
养殖黄粉虫可以吗，销路广吗？	
野生黄花鱼卖出天价 稀缺是主因 幸好有养殖 不然只能看标本了	
这1种随处可见的免费肥料，盆栽土里撒点它，叶绿花艳一年不黄叶	
访民情 惠民生 聚民心丨脱贫致富路上的驻村接力	
2018农村惠农新政策 国家会重点扶持这3类农业？	
「爱惠农」“天上不会掉馅饼”，2018年农村最新致富“骗局”	
定慧堂：中医为什么非要证明自己是科学的？（一）	
澳大利亚霍巴特遭遇五十多年来最大暴雨	
NBA季后赛球员没有工资，球员为何还要努力打进季后赛？	
与其说是航空母舰不如说是豪华游轮——意大利加富尔号航空母舰	
歼-20战斗机装备的是双管机炮还是加特林式机炮？	
村干部真的很幸运！加薪不算啥，未来还帮助养老，农民表示很支持	
这样还房贷能省几十万 银行却不告诉你-嘉易达地产	
贾鲁河上游按5A景区标准打造	
中考志愿填报，人生总有第一次｜2018中招简章分析大型讲座火热预约中！	
别再傻傻种蔬菜了！资深果农建议您种这8种珍稀果树，能养家糊口	
上联：弦拨三江春水。如何对下联？	
上联：一江雁影题秋句，如何对下联？	
你知道吗？矫正近视的“飞秒”竟可以用于角膜移植……	
山谷中的现代风格杰克逊养老乡村别墅	
在捷克杰兹罗附近的风景区，一辆1878年的蒸汽火车一直在营运	
癌，已成慢性病！十位专家解密十种肿瘤治疗	
火箭队2017-2018赛季总薪金是多少？今年夏天还有多余的空间吗？	
景区维权“金标准”：24小时内“有诉必应”	
金新农：4月份销售生猪2.07万头，环比增长11.89%	
整治金龙溪 引来活水润农田	
金枝玉叶花属于什么品种，怎样施肥，怎样浇水？	
是你老家吗？磐安这几个村晋升省A级景区村，颜值爆表！	
这七个专业本科就业不好，考研最有必要，工作后薪资高晋升快！	
你愿意当班主任吗？这个地方绩效工资、职称晋升向班主任倾斜！	
二十年后你准备好去敬老院养老了吗？	
你可曾记得那个地震中敬礼的男孩，他长大了！	
上联静可听落雪，下联怎么对？	
“春风十里 我在等你” 浪漫婚纱秀惊艳亮相九真山景区	
著名书法家、诗人巨剑诗歌欣赏	
又一世界级巨星拒来中超“养老”，理由让球迷叫好：有风骨够血性	
中超引援连失4大巨星 大联盟成养老首选J联赛后来居上	
卡52坠机现场照片曝光，专家分析曾遭导弹击中，俄罗斯却否认了	
卡皇2500万留队？火箭保夺冠阵容遇大麻烦，给保罗多少工资呢？	
将中医按揉护膝融入心脏康复运动	
脑卒中患者肩关节半脱位康复治疗	
中医五音疗法，心脏康复有疗效！	
肿瘤患者恢复期不可忽略的康复治疗	
《心血管疾病预防与康复临床路径丛书》新书发布	
家人如何帮助抑郁症患者康复？我的家庭走过的路	
「特色诊疗」全院大康复模式下康复评定的价值探讨	
该不该考驾照？	
近视眼可以考驾照吗	
在军队考驾照有多难？	
考驾照最难的是科目几？	
考驾照选择C1还是B2	
考驾照个人预约怎么预约？	
为什么那么多人着急考驾照？	
你知道吗？有的人不能考驾照	
考驾照注意这几点，快速拿本！	
在外省考驾照需要注意些什么？	
快五十岁的人该不该去考驾照？	
残疾人中哪类残疾不能考驾照？	
考驾照哪个科目最难过？为什么？	
考驾照科目三，有给教练保过费吗？	
为什么考驾照越来越贵，越来越难考？	
考驾照那点事，教练：你挂个跳档跳过去	
2018年考驾照，不看书也能让你通关	
学车考驾照，你属于呆萌型，还是天才型？	
记住这几个考驾照的技巧，再也不怕过不了了	
考驾照那些事，求求你别考驾照了，为什么？	
考驾照经验分享：学驾照时应该注意的都在这了	
网友：如果可以选择，我宁愿没有去报名考驾照	
2018年考驾照最快要多久才能拿到驾驶证？	
没考驾照的亲们有福了，轻轻松松帮你拿到手！	
还在辛苦的考驾照吗？未来或将不再需要考驾照了	
智能汽车上路，对没考驾照的人来说，是福音吗？	
你考驾照时，挂过多少次科？网友：差点跪下来磕头	
新手考驾照会遇到的问题及如何提高通过率避免补考	
没考驾照的有福了，驾考又出新规，又方便又省钱！	
考驾照痛苦？看看这些科目二的花式挂法，戳中笑点！	
考驾照科目一，科目二，科目三，科目四的补考费是多少啊？	
驾校出新规定了，还没考驾照的人偷着乐吧，这次改变很大！	
既然无人驾驶要到来，还有必要考驾照吗？	
大消息！无人驾驶汽车来了，再也不用考驾照了！	
上联:院有竹兰能悦目，请才子佳人下联？	
无人驾驶汽车管理规范出台了！没考驾照的亲们欢呼吧！	
没有方向感，驾照考试科二入库有什么诀窍吗？	
驾照考试，科三难还是科二难？	
组合拳让肛瘘伴直肠狭窄克罗恩患者重获新生	
美军福特号航母趴窝，二号舰肯尼迪号明年下水悬了？	
环球防务观察：“空天母舰”即将成为现实	
上联：喝孔府宴酒，下联怎么对？	
养殖孔雀闯出了一片天地	
创业农场56万亩水稻插秧工作拉开帷幕	
一图了解：防灾、减灾、救灾改革拉开序幕！——从应对单一灾种向综合减灾转变	
强势反击！伊朗打击行动拉开序幕，沙特首都遭遇导弹攻击！	
红碱淖景区“拉客”乱象：游客被骗假景区 不给钱就找人吓唬	
低价为幌子忽悠游客进“野景区”！“拉客仔”被行拘十日	
猪场里面小猪断奶拉稀多发，养猪人应该如何防治	
猪场里面小猪断奶拉稀多发，养猪人应该如何防治？	
仙人掌嫁接的蟹爪兰怎么施肥养护？仙人掌和蟹爪兰要优先照顾谁	
老花农专门提醒家庭养兰花，遇到这4种情况坚决不能施肥！农园艺	
如何给兰花施肥，施什么肥好	
泰国打造“养老天堂”，澳大利亚蓝皮书发布！	
房地产建设摄影：楼盘与蓝天白云相映，建筑工人施工忙！	
中医绝不是慢郎中——经方一剂愈病验案	
老杜对华究竟有几分诚意？刚刚，与美日澳军演开始！	
结婚5年一直带娃租房住，想买套自己的房子老公却不同意	
建议转给你老公看看！驾驶证吊销的细则，都在这了	
工资刚领到手，老公心急火燎的买了“魔鬼五金”，解决难题还不贵	
18年汽车用品越来越高级，安全又方便，发工资一定给老公买	
不得了，这几款汽车坐垫即将大火，高档舒适清爽，老公果断下手	
难怪老公把脚踏板全拆了，暴雨天开车装这神器，有效防止刮花生锈	
泥泞中的老虎，二战德国第一王牌坦克手，几乎灭掉了一个装甲师	
油门似老虎，拿到驾照可别忘了补全油门这一课	
驾驶大众高尔夫R扮猪吃老虎是什么感觉？	
卖猪肉能赚钱吗？老李卖猪肉收入竟比高管工资都高！	
老梁：美国军事水准最高的空军一号里面是什么样的	
老梁：当年这艘顶级巡洋舰“重庆号”为什么神秘失踪？背后有秘密	
猪场老母猪泪斑很多，是大病吗？养猪人应该怎么办？	
上联：老僧已死成新塔，如何对下联？	
上联：老翁田野锄杂草，如何对下联？	
房地产老总和房地产销售员工资差距100倍吗？看完你就知道了	
15岁患糖尿病，如今踏遍祖国大地，乐享人生！	
歼20的火控雷达有多厉害？	
二战舰载机没有雷达，是如何找到航母并返回航母上的？	
两千度等离子环绕雷达看不见，秘密研发三十年，美军还没缓过神来	
军迷沸腾了！歼20出海一举确立碾压性优势，歼10C雷达毫无反应	
丰田汽车雷克萨斯 IS：凭驾驶感受就能让你喜欢！	
雷雨季节！一定要学好这6个驾驶技巧，不然出门很难受	
「提醒」雷雨来袭！清远车主请收好这份雨天行车秘籍	
冰雹、冻雨、雷雨……它们都是哪来的？	
雷雨天气，如何安全行驶？	
南方雷雨天气来啦 知道这几点让爱车少受伤害、多份体贴	
大雷雨侵袭孟加拉国 近30人因遭雷击而丧命	
炎暑将临，雷雨增多！5月砂糖桔种植要知道的几件事	
酒驾司机满载3.4吨炸药上高速 警方惊出一身冷汗	
坦克发动机冷启动，二战古董坦克启动	
李国军：眼盲心明 养猪致富	李国军/nr
诗词欣赏：寄李儋元锡	
小李探花的诗词365之第193天	
击落以色列战机，却在立功不久后身亡，事情不简单！	
孟陬原创诗词‖蝶恋花·立夏（中华新韵）	
立夏之后雨水增多！桃树汛期如何管理	
立夏刚过，农作物田间管理的要点一定注意，这些坑，不能踩！	
丽格海棠的养殖注意这几点，远离病害花开到爆！	
西班牙航母能原地转向，连福特号都没有这种特殊的技能！	
攻击美国航母后果多严重？连俄罗斯都不敢 会招来全球范围报复	
越南老坦克走上了魔改之路：求以色列帮忙，连59D都不如有啥用？	
连交警觉得“冤”的4种违章，老司机都容易中招！	
连警察叔叔都觉得冤 居然这些行为竟然也会被算酒驾	
排号到2023年？到时候的车可能连驾照都不需要了！	
等我发工资了，一定买这套旅行茶具，连烧水都解决了，高档不占地	
玉米播种后没多久，遇到了连阴雨天，导致烂种怎么办？	
刘朝中：高危高血压患者的降压治疗	
刘罗锅的书法，书卷气太浓！浓得化不开！	
上联：水漫长堤鱼戏柳，下联如何对？	
地震被埋172小时获救的“最牛矿工” 如今已是技术工还种了柳杉林	
地震被埋172小时获救的“最牛矿工”如今已是技术工还种了柳杉林	
出一个上联：静看和风扬柳絮，求下联？	
下联：柳叶眉下送秋波，上联如何对？	
上联：龙腾天下，下联怎么对？	
上联：大水冲了龙王庙，怎么对下联？	
龙虾养殖前途怎么样？	
龙虾养殖“爬”出一条生态致富路	
龙虾养殖 “爬”出一条生态致富路	
龙虾养殖：每亩利润超两千，稻田轮养小龙虾范例	
刚刚，一枚导弹直奔这国首都，有400多万人口，传来巨大隆隆声	
寨卢小学多措并举积极开展防溺水安全宣传教育活动	
在非洲卢旺达生病，是最可怕的……	
又拿30万？曼联埃弗顿要填补鲁尼的工资差额	
伊朗陆军实力如何？	
现场直击！陆军防空导弹兵备战“晴空”比赛	
这型火炮性能并不是最好 但陆军表示我们愿意要 有多少要多少	
聚焦第78集团军某旅组建365天转型攻略——陆空新锐北域拓荒	
如果给绿巨人配个武器，应该配什么武器？	
老人手脚麻木怎么办？中医六种方法来治疗	
频发室早患者的麻醉管理需要注意哪些？	
接诊饱胃外伤患者，你该怎样进行麻醉管理？	
精品会议｜第十一届全国高危产科麻醉与分娩镇痛论坛	
生猛！这个女人当4年马刺助教，现在又要去应聘主教练！	
马刺格林本赛季对比，球迷：再这样打，和妖刀薪资换一下吧！	
美国权威媒体：莱昂纳德必离队，马刺今夏将赢大地震	
马蒂斯：已做好军事准备阻止伊朗研制核武器	
安装四台涡喷发动机，最大速度超过2马赫，服役生涯从未参战	
网约车战场的B面：你为什么总是约到“马甲车”？	
马甲车频现、爽约车……你都遇到过哪些网约车乱象？	
菲律宾东部海域发生6.1级地震 马尼拉有震感	
马仁奇峰飞龙玻璃桥景区游客火爆	
马仁奇峰飞龙玻璃桥景区游客火爆，不恐高的朋友有玩耍的地方喽？	
马翔：心血管疾病患者的睡眠障碍	马翔/nr
又到麦收季 2016秸秆禁烧重点区域已划定 谁家地着火就逮谁	
房产证满二或满五，缴税时有哪些差别？	
楷书墨迹《同治皇帝亲政诏书》满汉文对照	
上联：满山红叶诱人醉，怎么对下联？	
买二手房假房源满天飞？四招教你快速辨别假房源！	
今天才理解养殖户嘴里常说的家财万贯，带毛的不算的真正含义	
上联：猪不能没有毛，下联怎么对？	
每公里三四毛的适合开滴滴的车型都有哪些？	
相邻两个村，毛驴拉着犁杖种地和用播种机种地，是截然不同的人生	
上联：梅花开五福，下联：怎么对？	
上联：梅花喜欢漫天雪，如何对下联？	
上联：几枝梅花竖塘角，下联怎么对？	
上联：梅花落砚香薰字，如何对下联？	
以色列用梅卡瓦主战坦克追捕埃及人，结果被灭火剂搞得伤亡惨重	
够快！梅西真可以安心“养老”了？22岁亿元先生一场比赛给出答案	
上联是：梅香腊月三分雪，如何对下联？	
上联，梅雨天湿地湿人也湿，下联怎么对？	
龙虾养殖：梅雨季节小龙虾要格外“照顾”	
变态体罚学生舔同学屁股！美其名曰：古有卧薪尝胆，今有舔股思过	
上联：美人迟暮时，对下联？	
桃花山风景区美如画，无奈道路难行隐患多	
还没上车，滴滴司机已经知道你是“穿丝袜的美少女”了！	
还没上车 顺风车司机已经知道你是“穿丝袜的美少女”了？	
上联：一语惊醒梦中人，怎么对下联？	
春夏交际，苗木人如何应对洪涝？	
有哪些是高考后才明白的事？把握现在，青春才能无悔！	
处罚体育老师很容易，让家长明白上体育课不能穿凉鞋却很难！	
扇耳光、用脚踢，老师惩戒学生的“度”咋把握？看完这篇你就明白了……	
跟专业炒房团跑过后，才明白买房的差距有多大	
买房赠送面积能写进房产证证吗？看完你就明白了	
搞明白二手房交易流程只需五分钟，买房过户不再迷茫！	
买房是选现房好还是期房好? 售楼朋友的一席话让我全明白了!	
为何非洲人渴死也不挖井，饿死也不种地？看完才算明白了！	
鸡蛋每斤3.8元，养殖户真不赚钱？卖菜老板娘一说，全明白了！	
驾校你没学到的10点驾驶技巧，看一遍你就能明白	
为什么农村到处贴着出国招聘信息，这是真的吗？看完明白其中猫腻	
燃气灶打不着火？看完这10条你就明白了	
这些糖尿病饮食误区还是有人信，今天必须给您讲明白！	
高房价下，年轻人该不该花父母的养老钱买房？这些事你要想明白！	
养老金养老靠不靠谱？看完历年上调幅度的差异就明白了！	
这么美妙的书法竟出自这位明星笔下，真是有才！	
上联：莫道人间苦，下联怎么对？	
受台风“莫兰蒂”影响 9月15日部分高铁列车停运	
全球最强台风“莫兰蒂”强势登陆，上铁紧急停运、变更多趟列车	
上联：外世莫言是非少，如何对下联？	
上联：莫言今日无知已，下联怎么对？	
上联：月下作诗何需墨，如何对下联？	
母爱满满！狗妈妈暴雨中叼幼崽避雨 为其舔干身体	
护士节、母亲节游绿林山风景区免门票	
母亲节牵着母亲的手，老界岭景区走一走！	
0元逛景区｜母亲节大声说出爱 转动爱的“魔轮”	
母亲节合家欢，老界岭旅游度假风景区22周岁以上女性免门票	
第十五届尧山杜鹃花节送优惠 护士节、母亲节尧山景区免门票	
峄山风景区关于2018年中华母亲节期间 面向女性免费的公告	
福利！清远这些景区母亲节有重大优惠，赶紧带上妈妈一起去玩吧！	
哭成泪人，母亲节这天，母亲突然集体出现在军营	
双林诗词群雅集《六十四》母亲节专刊	
峄山风景区在中华母亲节期间推出惠民免票政策	
母亲节特惠｜娘子关、水上人家一日游	
浓情五月母亲节 盘点水城养老宜居楼盘项目	
母亲节别给妈妈报团旅游了，直接来段旅居式养老更易拓展寿命	
自驾游｜初夏去木兰围场旅行吧 攻略我已备好 美景美食美车你去吗	
突发！俄军又一架战机叙利亚坠毁，原因不明，眼前这慕令人不敢相信	
巅峰时期的纳粹德国有多强？看看他们这些武器就知道了	
全国最良心的景区，不但免门票还包吃住，南方人就是厚道	
春光退去夏登台，美景南风切换来 初夏诗词一组	
南艳湖700套新房补仓 仅4盘在卖房荒把买房人逼疯	
上联：宁可食无肉，下联怎么对？	
为什么有不少人宁可死在创业的路上也不拿死工资呢？	
摩托驾驶员为啥宁可被交警追着跑，也坚决不去考驾照？	
下联：夕阳西下，牧童牛背笛悠扬。如何对上联？	
「牛羊催肥」肉羊吃什么饲料催肥增重长得快，一天长7两-1斤	
农超对接实现农产品产销“零距离”	
农家乐生态园只用这一招迅速在当地打开知名度！	
农家乐经营不好？组合免费模式让你的农家乐轻松赚100万	
在农村有20亩左右的土地，应该怎么规划成一个小型的农场，或建成农家乐？	
诺如病毒 又双叒叕来袭，快看看如何科学防治	
帕金森最全知识来说，非老年人专利，6岁36岁患者都有	
关爱帕金森病人	
潘新明——新时代最具收藏价值的书画名家作品展	
上联：一夜暴富平步青云，下联怎么对？	
上联“笑谈千秋亊”，下联怎么对？	
上联：一树梨花千秋泪，怎么对下联？	
上联：文房四宝千秋志，如何对下联？	
上联：千秋笔墨惊天地，下联是什么？	
上联：云山一幅千秋画，如何对下联？	
下联：一轮明月醉千秋，如何对上联？	
买二手房要交多少钱才过户？	
帝王风采：乾隆皇帝的书法真迹选录	
500强刚说完不限学历，转身去了211招聘！	
2018首场大雨，多地迎来雨水天气，你家赶上了这批强降雨吗？	
强降雨后菜篮子波澜不惊 蔬菜肉蛋禽等供应充足	
67年一遇最强台风快要登陆，农民又要损失，快转吧！	
雨雨雨+强台风，深圳人的国庆可能要泡汤了！后面还有一大波台风	
为什么乔丹的工资可以不计入球队总薪资？	
上联：巧逢春景添月色，求下联？	
初中文化的“巧妇9妹”靠做网红年入1000万，苦读十六年的大学生毕业工资才5000，你怎么看？	
二战期间，美军口粮中的巧克力是哪里生产的？	
购房者未如期支付房款 法官巧调履行合同	
如何预防青光眼	
守护光明 抗击青光眼	
当心白内障与青光眼并袭致盲	
见光就落泪 小心患上青光眼畏光	
同仁微信课程｜青光眼的药物治疗	
同仁微信课程｜常见青光眼手术及术后眼部护理	
下联:青梅煮酒论英雄，上联？	
「关爱青少年」迁西实小 家长学校齐努力 护卫学生道路安全	
专家绘制青少年“近视地图”，这个省的“小眼镜”最多	
上联：草枯树黄秋风起，如何对下联？	
上联：秋风一动蝉先觉，如何对下联？	
上联：秋风渐冷残阳照，如何对下联？	
上联：秋风卷落相思叶，如何对下联？	
上联:霜打秋菊香更烈，如何对下联？	
上联：人去秋千闲挂月；求下联	
上联：秋水映月一船梦。如何对下联？	
下联：满目荒山秋意浓；求上联	
专家权威解答——水稻插秧后，水层管理注意啥呢？	
权威发声：今年养猪还有的赚！苦日子还在2019—2020年	
打车遭拒载怎么办？收下这份权威投诉攻略	
糖尿病饮食的权威指南	
禽流感流行期间能吃鸡肉吗？给你最权威的回答	
「权威发布」独家解读2018年市北区幼儿园招生	
五月有两场毕业生招聘会 200家用人单位任你选	
解放军今年的征兵广告，竟是腾讯做的王者荣耀版？	
融新教师招聘加分对象须16号前办理审核手续	
若某制造企业年亏损3亿，即使停产白给员工发工资年消耗也不超过1.3亿，为何要维持亏损状态生产？	
伊拉克战争前，萨达姆举行两次大阅兵，为何没吓住美国？	
美国发动海湾战争后，萨达姆为何第一时间向以色列发射导弹？	
诗词欣赏：塞下曲·其一	
成熟的2万多斤桑葚 愁坏了这位果农 快来帮一把！	
沙糖桔的六种根系施肥方法，你用过几种？	
连续暴雨后，沙糖桔果园被水浸后如何补救？	
以色列为什么呼吁沙特站出来共同反击伊朗？	
刚遭胡塞武装导弹袭击，沙特就派战机空袭，30多人伤亡	
伊朗传授胡塞武装4样独门暗器？无人战争让沙特吃尽苦头	
沙特无法全部拦截胡塞导弹，美军出动特种部队，猎杀导弹发射车	
沙鹰: 手枪的外皮-步枪的灵魂。众手枪: 这就是没人鸟你的理由	
后沙峪职工“以赛促学”切磋驾驶技能	
躲过了莎莉嘉，居然又迎来了台风海马，南方的多肉你们还好吗？	
上联：山青水秀云织锦。如何对下联？	
AED这么神勇，能代替人判断患者是否心跳停止吗？	
上联：楚门坎门沈家门三门临海，如何对下联？	
盛夏出行，如何预防疲劳驾驶？	
兵团第八师143团出动百台机车对棉花苗期喷洒农药防治病虫害	
「高考志愿填报」想要报师范当老师，报考前要弄清楚当老师优缺点	
被一所二本师范录取，可是不想上，复读值得吗？	
本科毕业的师范生可以去高中应聘老师吗？	
石鼓：防空防灾应急疏散演练 增强师生自救能力	
师生恋能有好结果吗？学生爱上老师是禁忌吗？	
猪价持续下跌，养猪赔钱！二师兄：俺也不想那么贱	
上联：白石板桥通南北。下联是什么？	
石家庄人注意！这两家房产中介存在问题	
谈谈我考取驾照的催泪史	
史上飞的最远的子弹，飞了多长时间？真的不敢相信	
印度研制出新式坦克，价格世界之最，质量却不咋地	
景区宰客现象屡禁不止，为维护旅游市场秩序，旅游违法行为将入刑	
行书要学就学——附带释文极品书法	
吃出来的世界长寿之乡，一根面做的寿星臊子面，让这个景区火爆	
兼顾驾驶乐趣与乘坐舒适性 试全新530Le	
行车上路驾驶十大傻，帅哥美女都要守交规	
平安四号丨双柏交警：联合路政部门开展货车治超行动	
下联:周六日双休。上联怎么对？	
建造大型水面舰艇的难度大还是建造5代机的难度大？	
滴滴悬赏百万寻觅司老司机，故作姿态至今无人慰问	
斯诺克裁判工资多少一个月？	
打车还是买车？SWM斯威X7试驾送车！	
打车还是买车？试驾SWM斯威X7给你答案！	
上联：斯文存天地。求高手对下联？	
最令二战苏军女兵耻辱的女叛徒，居然躲过了三十多年的追捕	
此役苏军给日军留了条生路反遭偷袭，大怒之下发誓要杀光日军	
二战期间，苏军在柏林战役中使用的这种战术队形，让德军损失惨重	
精品病例｜全麻苏醒期喉痉挛一例	
如何评价孙晓云的书法？	
老人的房产过户给孙子如何办理手续	
老人的房产过户给孙子如何办理手续？	
“5.12地震中最牛车”车主告诉孙子：它代表着“压不倒、震不垮”的精神	
5.12地震中最牛车，车主告诉孙子：要有“压不倒、震不垮”的精神	
100多万学生等得太久了，大学专业类科目选考何时公布？	
泰康养老全力投入税延养老产品开发设计	
NBA决赛4队薪金排名！保罗第6，希尔第8，汤普森最尴尬还没替补高	
十五句诗词，寻找唐诗宋词里思念的忧伤	
各国领导人工资是多少？特朗普工资你可能不敢相信	
北约后院失火！内战已经箭在弦上，土耳其向特朗普发出严厉警告	
美突遭“后院失火”? 此北约大国强势警告特朗普	
87%家长认为取消高考特长生加分能减少伪特长	
87%受访家长认为取消高考特长生加分能减少伪特长	
87.0%受访家长觉得取消高考特长生加分能减少“伪特长”	
87.0%受访家长认为应取消高考特长生加分	
上联：天公送一场雪掩饰人间丑陋，如何对下联？	
睡不着，怎么办？中医分享“一觉到天亮”好方法！	
大部景区天晴好出游 午后气温较高需防晒	
白羊座天王星，与网约车的七年之痒	
上联：鸡啼三更天未明，如何接下联？	
天柱山风景区高空玻璃桥是什么样的？	
农村俗语：“养猪肥了田，不愁兜没钱”，养猪人怎么降低成本？	
田氏书法组织丑闻曝光，弟子退师公告震惊书法界！	
京北一日游——葡萄架下慢生活，关外萄园享田野	
共享农场未来田园发展大趋势	
原创书法12：夏日田园杂兴·其七	
上联：观海听涛看波浪滚滚，怎么对下联？	
对越自卫反击战记忆——一名通信兵的战斗经历	
大学录取通知书附带的家庭条件调查表有用吗？	
大学录取通知书上的编号是什么意思？	
扶贫日志｜生态养殖拓宽致富路 贫困群众脱贫热情高	
人类历史上出现过的超级大地震：9.5级瓦尔迪维亚大地震	
加拿大万锦华人区民宅突发大火 一人当场死亡	
「诗词鉴赏」千树万树梨花开	
哪把步枪是你眼中的“步枪之王”？	
刺激战场：搭配7.62的狗杂，步枪伤害之王	
蜜蜂养殖中，正确的关王方法是什么？怎么关王才能保证蜂王不死？	
上联：王不点头难做主，怎么对下联？	
王洪涛硬笔正楷书写法则——偏旁部首篇	王洪涛/nr
为什么买二手房才是王道？	
上联：王老吉，如何对下联？	
王献之书法精选名帖，学习书法必备	王献之/nr
王献之《草书九帖》——希世珍品，值得收藏	王献之/nr
下联：望子成龙慈母心。有什么上联？	
房地产成倍涨价，实体经济却步步维艰，你该怎么办？	
维生素C在养鸡中的作用	
银大·蔚未来│买期房好还是买现房好？	
四季豆写魏碑书法，人才啊！	
汉字书写和书法历史概述之魏晋南北朝书法	
古海温泉一日游	
古海温泉二日游	
京北一日游——湖水山脉环绕着一片温泉桃源	
十首温庭筠诗词：千万恨，恨极在天涯	
这样的中式客厅装饰，一幅书法一个温馨的家	
我跑滴滴的第一天，过程很艰辛，结果很温馨	
文博会“观澜板块”崛起	
文博会上手绘画作品受欢迎	
墙内失火 文德恩又遭德国政界人士声讨	
最受文科生欢迎的十所大学 盘点最受文科生青睐的十所名校18	
不文明行为曝光台：景区观光，别让陋习煞美景	
临渭交警：不文明交通违法曝光台 行人的你是否在其中！	
民国报刊收藏大王故居和开封三眼井文殊寺改造	
背书很少能写好高考文综吗？	
下联：恰遇秋霜闻雁讯，有什么上联？	
销售驾驶沃尔沃S90撞上花坛，是车不行还是技术不行？	
乌骨鸡雏鸡养殖技术介绍	
怎样进行乌骨鸡雏鸡养殖？	
俄罗斯入侵乌克兰后并未交火，民众为何主动向俄军举旗欢迎？	
又出事了！乌克兰超级军火库发生火灾，俄媒直言这事绝对不简单	
下联:乌云有心雨润地，如何对上联？	
上联:进门来乌云盖顶，下联怎么对？	
诗词欣赏：杂诗（无名氏）	
比死神还要先进的无人驾驶战斗机，美国最新隐身无人机简介	
无人驾驶和有人驾驶，哪个更靠谱？	
无人驾驶、自主驾驶傻傻分不清楚？	
无人驾驶汽车真的能实现智能安全驾驶吗？	
Waymo计划年内正式推出无人驾驶打车服务	
吴炳祥：急性肺栓塞规范化诊治	吴炳祥/nr
“五老峰杯”全国健身鞭交流大会在五老峰景区隆重举行	
俄罗斯为什么自废武功，销毁台风级战略核潜艇？	
土豆嫁接西红柿，上摘西红柿，下挖土豆，边摘边吃大半年！	
西石高速公路多部门联合开展汛期边坡塌方抢险应急演练	
五谷杂粮，西医说要少吃，中医说要多吃，听谁的？	
四位院士力挺中医：中医解决了很多西医解决不了的问题	
都别吵了听我说，在治病方面，中医西医互为主角与配角	
上联：惜缘长怕君先去；求下联	
钢铁侠装甲和黑豹战衣哪个科技更高，为什么？	
大众夏朗，驾驶它是一种什么样的体验，看车主是怎么说的	
夏收小麦减产成定局了吗？来看看一线调研的情况	
小麦夏收即将展开，这样做每亩至少多收100斤！	
美国夏威夷火山爆发，同时伴随6.9级地震，一千度岩浆溢出	
火山爆发、7天800次地震：夏威夷进入“震动模式”？	
火山喷发、强震过后 夏威夷人绷紧神经	
快救宠物！夏威夷火山喷发持续 或再度触发地震	
夏威夷40年来最强地震	
夏威夷地震引起火山喷发 1700岛民被迫撤离	
夏威夷发生6.9级地震	
夏威夷发生6.9级地震，火山喷发致万人撤离！	
夏威夷火山爆发！夏威夷遭受6.9级地震袭击，引发海啸担忧！	
夏威夷火山发威后又地震 近万人强制疏散	
夏威夷火山喷发无停止迹象 强震不断引发次生灾害	
夏威夷连遭火山喷发地震袭击 住宅区流岩浆万人撤离	
突发！夏威夷发生6.9级地震！基拉韦厄火山喷发！上万人撤离！	
春夏之交，养猪户们该如何防止病猪的出现？	
上联：一花香艳千人醉。下联是什么？	
小柴胡颗粒也能治胃病？「跟己安先生学中医」	
为车牌变身 他耍了小聪明 被交警查获 要付出大代价	
雾漫小东江景区——云蒸霞蔚，朦胧缥纱，如梦似幻！	
找到一本老字帖，小楷书法精美绝伦	
书法中小楷写的是功底，更是对书法的至真情怀！	
如何用稻田养殖小龙虾？	
小龙虾养殖种植哪种水草好？	
老百姓养殖小龙虾到底赚不赚钱？	
养殖小龙虾一亩究竟有多少产量？	
小龙虾的养殖前景及市场前景如何？	
小龙虾养殖（二）场地的设计和施工	
针对小龙虾养殖青苔问题的几点建议	
小龙虾价格暴涨，养殖户赚钱了吗？	
小龙虾卖那么贵，养殖成本大约多少？	
小龙虾怎么养殖？需要什么环境条件啊？	
河蟹、小龙虾养殖成功水草作用很关键！	
小龙虾养殖火爆，送你一份养殖手册，请收好！	
养殖小龙虾做好防控措施，五月魔咒并不可怕！	
2018-5月对小龙虾养殖青苔问题的几点建议	
2018年5月8日全国部分水产市场小龙虾价格	
小龙虾价涨销量升 养殖地：500多斤赚五、六千元	
如何评论现在农村基本农田被大面积挖成小龙虾养殖塘？	
小龙虾的养殖摧生出了各种行业，其中合作社算是比较成功的一例	
小龙虾在暴雨前后水体缺氧的原理以及应对措施	
职场孕期小麻烦，中医穴位按摩来帮你！	
报名｜名中医公益课堂“小满时节话祛湿”	
养猪过程中的几个小妙招，值得农村养猪户们收藏！	
调料煮水能治疗高血压？六个你没听过的降压小妙招	
美食小妙招：春风暖，病毒狂！体弱之人如何养正气	
上联：绿水小桥一壶酒；如何接下联？	
“小升初”生源之争——没有最好的学校只有最适合的教育	
“小升初”新政落地家长焦虑 该不该给娃报个班	
重磅关注：2018小升初五大名校这几所本部与分校将独立报名和摇号	
重磅！校方提醒家长小升初报名时应注意这些重要问题！	
小升初要做“亲子鉴定”？教育办：造假太多！	
小升初升学季来临，如何才能做个不焦虑的家长？	
小升初面谈网络报名结束，家长可以做哪些准备？	
小升初面谈必看！注意这些最后关头还能加分的“隐形加分项”	
升学资讯｜小升初未上岸的家长注意！这7所民办校报名通道开通中	
2018小升初加油站｜小升初，预备年级家长注意！教改新规后，初中语文学习如何调整	
2018小升初特长生报名开始，速看各城区招生细则	
小升初特长生招生即将取消，培养孩子的特长还有用吗？	
美国军事强大，为什么发动战争时要拉上英法等一帮小兄弟为它助阵？	
小学生作文不及格，老师将学生屁股打青被家长投诉	
学校让小学生模拟重走长征路，作为家长您是否赞同	
小学生作文不及格 老师将学生屁股打青	
小学生面对作业叫苦连连，老师说属于正常范围，家长很无奈	
小学生家长在班级群怒怼老师，被老师回应后踢出群 网友：很现实	
小学生家长“撕起来”老师安排座位不公平被踢出群 网友评论炸了	
小学生策划消防教育活动 提升对消防知识的了解	
小学生安全教育试题及答案	
美国免费向这个国家送小鹰号航母惨遭拒绝，今旧事重演，结果瞬变	
上联：今日小雨迎立夏，如何对下联？	
上联：小雨飘兮春已到，下联怎么对？	
“生态景区+休闲养生”构筑特色小镇	
花100亿元打造一座旅游小镇，成了道教文化景区	
原创上联：月落星稀天将晓，如何对下联？	
上联：竹子躬身谢时雨，下联怎么对？	
班级群多回复个谢谢老师，被其他家长说拍马屁，家长：就你最特殊	
请问一个人珠海一日游，吃，下周穿什么合适？谢谢，没去过，头一次去，请帮忙谢谢？	
原创诗词「七绝」渔夫曲 心羽浮沉又此霄	
老兵信鹏创办公司年入3000万，从普通士兵到创业达人的华丽转身！	
「大整治」整治非机动车“任性”行为 修武交警在行动	
购房者须知：买房进售楼处购房者要怎么问？	
就医须知｜网诊和面诊的态度差别怎么就这么大呢？	
上联：斜阳徐徐下西岭，此联如何对？	
在未取得商品房预售许可证明的情形时买受人如何主张自己的权利？	
上联：九日为旭，人人从，下联是什么？	
那些常识骗了你，房地产销售中精美宣传册的玄机	
通道：开创各种形式的“防灾减灾”宣传教育	
消除火灾隐患 共建地铁平安119消防宣传周地铁消防还能这么练！你肯定没见过	
上联:雪飞风冷早闭户，求下联？	
上联：花舞雪飞粘浅袖，下联怎么对？	
「原创对联」雪霁霜零露雲霞 请赐上联	
上联：踏遍青山寻鹤迹，如何对下联？	
上联：梦里寻君千百回，如何对下联？	
下联：窗破月寻人：求上联	
书法雅赏——世上没有不平的事，只有不平的心	
没输球也降工资！亚冠恒大0-0战平权健，恒大因“丢人”降6人工资	
解放军内部腐败分子暴露身份，以为燕双鹰不敢开枪，没想到被爆头	
一键收藏，初夏阳光海滩自驾游超实用指南	
感受激情阳光，体验多彩风情—砂器故里·贡椒之乡亲子自驾两日游	
阳光玫瑰嫁接之十大要点！一步一步教你还怕学不会	
举一反三：中医食疗养生很简单！先把“阳虚”搞定！	
阳虚痰湿水湿所致眩晕，中医调理思路方法参考！附案例	
杨总得了糖尿病 这酒还能不能喝了？	杨总/nr
印度厕所“所长”，每月500块钱工资养5个小孩，吃住都在厕所！	
我想回家养牛，打算养10头左右，有什么需要注意的吗？	
为什么有养鸡场却没有养狗厂？	
“养老”也变成了变相的炒房？！	
个税递延型养老保险试点落地 开启个人养老新时代	
中法将进一步推进养老服务业领域的合作	
中国人如何办理泰国养老签证？	
“光伏养老”在众多养老模式中脱颖而出	
2018拥有塞浦路斯护照能为医疗和养老带来那些便利方面的优势？	
45岁单身男在泰国首都曼谷退休养老，包括吃穿住行适当娱乐，一个月要准备多少钱？	
50岁，多少钱够养老？	
80后的养老危机，别指望安享晚年了！	
帮百姓打理积蓄 以养老为目标的公募基金呼之欲出	
帮助普通百姓打理手头积蓄，专门以养老为目标的公募基金呼之欲出	
不靠养儿防老的瑞典，如何实现在家养老？	
当你老了，谁来养老？看看海外都咋做的	
各个国家流行的养老方式，你中意哪一款？	
买房的代价：花掉父母的养老钱，还半辈子的债！	
你知道你的房子有一笔“养老基金”吗？	
农民工最心酸事之五：劳累一生，养老无着	
如何破解养老地产发展痛点？	
商业保险真的可以用于养老吗？	
税延养老：吸引中高收入人群的福利	
我国最适合人类居住的城市，悠闲散漫直养老，最后一个上榜很意外	
现在50岁，有100万够养老吗？	
养老定居，选择珠三角城市好还是长三角城市好？	
养老或将成为头号难题，是否会老无所依？	
养老基金清查大限 违规产品加速撤离	
养老目标基金渐行渐近 这些基金扎堆改名字	
这个政策一出，养老问题保障了，但这些人却老无所依了！	
最适合安家养老的城市？	
「热点」事关所有缴纳养老的农民！你能多领多少钱？	
5套一层农村小别墅，施工简单造价低，最适合建给父母养老	
城里人的退休就是每天跳跳广场舞，而农村人的养老就是干活干到老	
当你年老时，是留在城市还是到乡村的老家养老？	
国家要给农村65岁以上老人“发工资”了，以后农民养老无压力了！	
老了以后你想回农村养老吗？	
农村二女户二女出嫁留下二老后二老如何养老？	
农村老人怎么养老？	
农村六十岁以上的老人该怎么养老？	
农村面临的养老问题，从现在开始买养老保险，让你养老过的更轻松	
农村养老问题难主要在这 什么时候可以得到解决？	
农民多少岁才能退休养老？都有什么保障？	
农民将来该如何养老？	
浅谈农民养老问题	
速看，新政策发布，农民每个月可以多领这么钱，以后养老不用愁了	
为什么越来越多的人选择来农村养老？	
未来农民会怎么养老？	
新中式小院15X25米，适合农村养老，比别墅还美！	
养老新模式：跟着保姆回农村	
一娘能养十儿女，十儿难养娘一人，农村老人养老现状，一声叹息	
因儿子每次回农村上旱厕都被咬一屁股包，狂砸40万农村自建房养老	
走进养老服务业发展新时代——养老服务业发展典型案例汇编之农村养老项目（1）	
NBA6大养老合同，科比湖人相濡以沫，火箭5年6000万续约夺冠功臣	
都说70人可能成为最无奈的养老一代，为什么？	
外国老头都爱到这个地方养老，花钱就有美女陪伴颐养天年！	
不交养老金 , 每月存1000, 30年后够养老吗？	
还没买养老金，老年的生活保障会受到影响，三招帮你解决养老问题	
还为养老发愁？国家给65岁以上的农村老人增发养老金，等着享福吧	
利好！国家上涨农村养老基础养老金每人每月88元！网友的评论绝了	
现在养牛挣钱吗？	
几种养牛饲料的优势	
养牛羊怎么增膘长肉快？	
肉牛养殖户要注意的养牛误区	
养牛风险不大，为什么农村很少有人养牛？	
农村养牛那么赚钱   为什么都选择养猪呢？	
现在养牛户忙于买小肉牛，肉牛养殖前景如何？	
养牛的朋友进来看看，新建的牛棚，欢迎大家点评	
养牛知识：刚买回的肉牛感冒 母牛产后无奶怎么办？	
不知看哭多少农村养牛人，农村养牛最悲痛的事，看后你啥感受	
这些养生茶千万别乱喝，听听中医怎么说	
各位养殖户注意，2018年请放心养羊！	
地震失去双腿，年过50母亲养羊帮筹集资金，如今开了两家店	
上联：荷田雨打叶；怎么接下联？	
薄荷的养殖方法和注意事项有哪些？叶子发黄怎么办？怎么修剪？	
伊郎强硬反击，就西方要求对其导弹防御系统进行谈判，表明了什么？	
伊旗坐滴滴的注意了！21岁空姐深夜死于网约车！	
老年患者用药依从性差，是治疗失败的原因之一	
上联:忆往昔情深意重，有下联者请对？	
葡萄施肥大全顺口溜，好记易懂，你值得拥有	
新西兰研究：益生菌可降低怀孕期间患糖尿病的风险	
大学录取通知书来了，里面却夹着银行卡，这合理么？	
大学录取通知书中的银行卡可以在家转学费进去吗？	
英超六强后卫工资一览表：曼城后卫工资最高失球最少	
上联：风摇绿柳迎春燕，如何对下联？	
映山红可以放家里吗，映山红花怎么养殖	
服务到一线 永仁交警送考下乡	
服务到一线，永仁交警下乡进行摩托车考试	
不敢相信！世界最强特种兵到底有多强？一般人根本承受不了！	
惊！下周房贷利息又双叒涨，银行打劫刚需≈房价涨10%！	
内乡幼儿园一分园组织开展防溺水安全教育签名活动	
“恒大·嗨娃杯”幼儿篮球赛参赛幼儿园风采展示	
“小豆包”进幼儿园科普消防知识	
2018幼儿园招生启动，想要孩子不哭不闹入园，这些事得准备	
幼儿园老师惩罚学生微信发错群，家长很生气，老师被开除？	
都说幼儿园老师对幼儿不好，你们知道她们工资是多少吗？	
为什么幼儿园收着高额的学费，给老师的工资却那么低？	
幼儿园老师每个月工资有多少？揭开真实收入，太出乎意料了！	
上幼儿园必须打的疫苗，检查一下你家宝宝是否有漏种	
幼升小家长必看，让孩子爱上国学	
于右任书法作品展	
1988年鱼雷直接插入核潜艇是怎么回事？	
万吨核潜艇摸进美军航母编队，就差一颗鱼雷，报销美国航母	
上联：雨淋荷花荷更洁，怎么对下联？	
上联：春花谱曲话雨露，下联怎么对？	
上联：微雨蒙蒙芳草渡，如何对下联？	
对联：雨柔花无缺，怎么对对联？	
上联:江南听雨知春暖，求下联？	
玉露播种小技巧，简单易学，越养越水灵！	
玉米现在病虫害应该怎样防治？	
效率超高的卧式玉米饲料粉碎机	
玉米最后一次施肥应在什么时候？	
免耕玉米播种机什么牌子的好使？	
玉米播种后只生根不发芽啥原因？咋解决？	
「预警」农业农村部提醒您：今年种玉米仍需谨慎	
玉米饲料粉碎机也有卧式的，养殖户朋友们都来看看	
玉米播种后一直等雨，长时间干旱我们应该怎么办？	
玉米种植面积扩大，肥料跟着涨价！夏季肥行情会火爆吗	
种地需看：今日我国北方产区销区最新玉米、大豆价格行情	
种地售粮需看：今日我国北方地区最新玉米、大豆最新价格	
农业农村部再三提醒：不要盲目种玉米！有多少农民会听？	
化肥涨价，农药涨价，人工涨价，水电费涨价，玉米能涨价吗？	
玉米苗后除草剂药害严重影响产量？快看最全玉米药害解决办法	
今年玉米种植面积扩大，肥料跟着涨价！夏季肥行情会火爆吗？	
玉米出苗，病害也即将大面积发生，这些病害和防治方法收好了！	
5月9日玉米市场：各大机构纷纷北上考察春播，发现国储启动轮入	
发酵秸秆饲料养猪具体操作流程！三斤秸秆相当于一斤玉米的价值！	
同一块地，同一个品种，同时播种，为什么会出现玉米苗长得大小不一的现象？	
南方狂风暴雨，柑橘泡水、玉米全倒！未来十天，仍有强降雨！	
专家权威解答：不是施肥越多，玉米产量越高，关键还得看这点！	
助农增收，正确使用玉米田除草剂	
神奇的玉米须，治糖尿病效果好，还能防治并发症	
全球军衔最高的人，被7个国家授以元帅军衔，只因其打败一个敌人	
农户院落种了这多月月红，生活好了，更爱美的生活	
因抖音爆红的六大景区，你去过几个？网友：越红越不要去	
对越反击战，越军遗体是如何处理的？	
越南人等放闸洪水，跳到河里去捡“稀世珍宝”	
越秀｜越秀打响2018年征兵工作“第一枪”：下一站，军营见！	
上联:鹤耀云霄九洲庆丰年，下联？	
发现导游宰客应该怎么办？	
在旅行途中遭遇宰客行为，应该怎么办？	
出门旅游被坑你怕不怕？这些欺客宰客现象要入刑了	
讲义气不宰客的良心城市，每年接待几亿人却不怎么赚钱	
骑士未来的工资如何，会影响詹姆斯留队吗？	
2018买房新规：这3张证明比房产证更重要！小心保管好！	
大学录取通知书里有张银行卡，这种行为是否是强制消费？	
上联：人情似纸张张薄，下联如何对？	
小伙一张开嘴就是苹果味，没想到竟是糖尿病的信号	
美军“战斧”叙利亚折戟：美叙俄各执一词 专家却一眼看出端倪	
养老地产已然成为巨大风口！蜂拥而至后又为何纷纷折戟？	
房产之争没有赢家，回归情感真爱才是真谛	
菜农这样给茄子浇水，真是太有才了，涨知识！	
支付宝能不能把蚂蚁森林创办成旅游景区？	
如何避免植保工作中存在的农作物药害？	
C919已获815架订单 国产大飞机志存高远	
「考场佳作」高考模拟优秀作文欣赏：从阅读中汲取营养和智慧	
出自诗词名句中的智慧好名字欣赏	
相信中医，相信中医会让我们健康快乐智慧的活着	
海南今年将新增深水网箱750口 新建3个大型智能化养殖渔场	
智能化愈演愈烈，卡车自动驾驶离我们还有多远	
二手房周成交量减半	
我市开展民营企业招聘周活动	
著名的的中医经络专家随钢周与他的“随氏通”经络疏通仪	
旅游文化：周边游哪里好玩一日游？5月最适合旅游的地方	
上联：周公难解红楼梦，下联怎么对？	
经常听到球员十几二十万周薪，他们是不是每周发工资？	
他不肯签字，可经纪人却一直在跟球队周旋？这是嫌工资低？	
如何评价朱啸虎「我套现后哪管洪水滔天」的投资风格？	
上联，朱雀桥边照飞燕，如何对下联？	
重温那段激情岁月，一起为广大考生，送上默默祝福吧！	
子弟兵是我们最可爱的人：实拍抗洪部队回撤，民众挥手致谢	
致敬！救灾现场的子弟兵各式睡姿，倒地就睡，他们太累了	
子墨老师和你聊聊高考前一个月，最后冲刺考生复习重心该放哪？	
子墨老师高考志愿填报“7+3”模式每日一校：「中国政法大学」	
子墨老师高考志愿填报“7+3”模式每日一校：「首都师范大学」	
子墨老师高考志愿填报“7+3”模式每日一校：「北京邮电大学」	
子墨老师带你冲刺2018年高考—高中物理公式大总结	
子墨老师带你冲刺2018年高考—高考语文冲刺策略	
子墨老师带你冲刺2018年高考—高考化学最后备战	
子墨老师带你冲刺2018年高考—高考化学必备机物常见除杂方法	
书法家邹新林 行云流水 落笔如云烟	
上联：醉里乾坤大，如何对下联？	
上联：醉柳长斜，卧看浓云遮晚照，如何对下联？	
告诉我，你姓什么？是不是醉美在诗词里	
网约车乱象调查：正规平台下10单 来了7台黑车	
11楼以上发生火灾，消防可灭火吗？	
全国16省公布2018年一季度生猪养殖情况	
安徽池州市 28家A级景区针对全省16市市民实施门票分期免费活动	
“三点半”接送孩子难的家长快看！河北1市中小学全面开展“延时服务”	
2008年汶川地震后，从北京前往北川的记录	
太原新增3家市医保定点医院	
2018教师招聘考试｜心理学简述题简答题48道！	
赚钱故事第49集：景区卖辣椒酱的	
被瞧不起的5门大学专业，好就业工资高，未来20年人才需求大！	
哈尔滨：即日起主城6区新购商品房满3年方可交易	
限售观察：哈市主城6区新房3年内不能卖！公积金贷款有多难？	
西安国企4000元工资相当于私企多少钱？	
滴滴司机接跨省天价订单 乘客半路改道至今未付款	
上联：山水不曾随我老，如何对下联？	
大池对联作品选刊	
收藏｜北京故宫镇院十大名画	
癌症患者大山里组成抗癌部落	
农村十大新现象之一：耕地荒芜非常可惜	
最受考研人欢迎的城市，有你报考高校所在的城市吗？	
这里是全中国最“假”的城市，“造假”造出了举世闻名的5A级景区	
厉害了我的国！刚刚，一款国产武器在异国他乡大出风头	
农场究竟应该怎么运营？这样让你的农场火起来！	
120万！他把收藏多年的镇馆之宝给卖了！	
第二次车臣战争对于俄军有什么不一样，有什么战术？	
为什么俄罗斯每年都要红场阅兵？	
八五二农场第四管理区“五比五看”劳动竞赛营造水稻插秧氛围	
八五五农场党员干部多措并举助力春播	
车顶摆玩偶很拉风？宝应交警开启处罚模式	
“翰墨传承书法作品展”北京站开幕	
毕节大方交警开展形式丰富多彩的“五个一”进驾校活动	
假如你是炒房团，绝地求生里哪个城区的房子最值得投资？	
B52飞冲绳 台媒：是在练习攻击大陆航母	
台湾的驾照能在大陆使用吗，如果能该怎么用？	
飞机背着大型航天飞机飞行，可以在地球低轨道条件下空中发射	
一颗原子弹威力达到多大，才能将地球毁灭？真正答案让人无言以对	
一地震就要送命，这条鱼可能是地球上最痛恨地震的动物了	
下联：月照孤村三两家；求上联	
“湖光山色”房车自驾游 游进你的心中	
上联：建东台，唱西游，南腔北调，请接下联？	
上联，江南江南阴雨绵绵，如何对下联？	
太平营街道：特色产业鼓起农户“钱袋子”	
上联：碣石山上观沧海，如何对下联？	
二本高校推荐：九所二本最有前景综合性大学	
军营里什么级别的军人才能住军区大院？	
怎么去非洲开农场，做生意？	
在花盆里加个生鸡蛋 ，从此以后植物疯长，一年都不用再施肥	
上联：风卷连城墙欲倒，如何对下联？	
每袋135元的肥料最多值60多元！忽悠团联合村干部合伙坑害农民！	
每袋135元的肥料，最多值60多元！忽悠团联合村干部合伙坑害农民	
养鸡｜话说搞好“两道一免”是重点	
海面上亮起两道闪光，六级地震随之而来，世界上又多了个有核国家	
哈市限售六城区新房3年内不能卖，调整住房公积金贷款条件	
上联:春风又绿江南岸；怎么接下联？	
搞家庭农场，合作社如何去平衡各级关系？	
最接地气的亲子农场遍地开花，真正会玩的在这里！	
亲子农场丨365天全年无休，你能给她最好的薪水是什么？	
中国人来了！非洲荒地变农场：拖拉机成了高科技，大葱比手臂还粗	
农场着火主人慌忙逃生，狗狗留守救出一票小弟	
苹果树栽培技术｜苹果园科学施肥方案	
上联：红烛落泪千里行，下联怎么对？	
布局自驾游 锡盟推“千里草原风景大道”	
农村俗语：“千条路，万条路，养猪是条富裕路”，养猪人怎么看？	
下联：清水出芙蓉；求上联	
上联：清水出芙蓉，下联怎么对？	
刚拿驾照没多久，不敢一个人上路开车怎么办？	
上联：人向门中闪，如何对下联？	
5月5日起兴义各景区对京津冀地区游客实行门票全免	
汛期雨急隧道口突发泥石流 高速一支队三大队紧急协调处置排险保通	
山大加入高校争才战：再拿不出好的体制机制，滑坡可能会更快	
上联是“知山知水谁知己”，如何对下联？	
你所在的学校、社区、单位组织过地震疏散演练吗？	
「交警动态」辉南交警严厉整治涉牌涉证违法行为	
胜利农场全面加快旱田播种进度	
世界首家十星级酒店，一年工资只能住一晚	
曙光农场召开2018年水稻插秧定标会	
关注｜双流司机注意！当酒驾遇上碰瓷……	
洪灾过后，番茄管理要迈的四道“坎”	
上联：落花无意随水去，下联怎么对？	
土乡家庭农场的领头雁	
上联：长空万里看山河，如何对下联？	
东北地区补课一节课高达千元还有价无市，如果补课被取缔，最终受益方是谁？	
我国军舰刚到印度洋，就被50艘战舰突然包围，西方：有好戏看了	
西华：今年农机购置补贴本月启动 投入补贴达1700万元	
上联：问东西南北，相逢何处，下联怎么对？	
上联：水流桥下，今水非昔水，如何对下联？	
榆社中高考考生与家长心理调适公益讲座在县文体活动中心圆满举行	
河滨县发生多次地震 大地震就要来临？	
为何三四线小城市房价飞速上涨，但工资不涨？	
三农问题如果不解决，振新农村完全无从谈起！	
9月新农村医保报销范围和比例你知道吗？都看看吧！	
2018新中高考改革实施策略与个性化教学研讨会在蓉举行	
养殖场抽粪泵浅谈	
为何一定要打压小型养殖场？	
养殖场如何掌握蛋价的话语权？	
养殖场怎样才能掌握蛋价的话语权？	
EPS模块能否建设养殖场？成本如何？	
养殖场禁养，转型升级以后，可以不拆吗？	
生猪行情如此低迷，小规模养殖场应该如何面对？	
请问建一个出栏，五百头生猪的养殖场，大约多少钱？	
上联：轻雾弄烟夜江静，如何对下联？	
老兵书法家：一条街的对联竟然都是他写的	
上联：春风赐雨千山秀。下联是什么？	
让游人淡忘了的老景区长寿村：还会再火起来吗？	
一大波招聘岗位来袭！来华政园做个同事吧～	
俄舰队启航参加中俄联合演习，三艘舰龄之和尴尬超一百年	
5天后就是大限！美军正考虑军事打击伊朗，中俄明确作出表态	
美出台国防授权法案应对中俄竞争 国防预算超7000亿美元	
血战到底！伊朗军方：一旦美军越过底线，必反击！中俄鼎力支持	
为什么工程类应届毕业生不愿去中铁、中水、中建、中交的基层，是工资低还是条件苦？	
“读透”中考电子阅卷流程，避免考试失分雷区，考试少扣20分！	
“华文教育名师巡讲团”巴黎开讲	
“我来当回坏人”，美国女老师认为校园枪击案不断的根源在家长	
「5.15活动」理工科专业留学深度解析校园巡讲-西电专场	
「独家重磅」广渠门中学“让生命影响生命” 集团化办学为学生提供更优质的教育资源	
「津云视点」延时放学解“三点半”难题，家长满意吗？	
「科普」加拿大留学要多长时间？加拿大名校的学分制解析！	
「名校经验」衡水中学高考冲刺备考细节：将潜力挖到极致	
「新闻」台大“新五四运动”爆冲突 “反管”学生自导自演遭讽是戏精	
「重磅」2018年华夏鲲鹏自主招生复试集训预告！报名进行时！全真	
中考志愿填报+新高考政策解读，尽在2018中考志愿填报讲座	
中考要到啦！作为家长应该准备些什么？	
2018年北大清华自主招生初审名单公布，重庆地区共138人入选	
中考、高考在即，如何帮助孩子搞好生涯规划	
2018年贵安新区6所普通高中计划招生840人	
2018年全国普通高校招生安全工作电视电话会议在京召开	
2018年新兴经济体大学排名揭晓，中国94所高校上榜！	
2018志愿填报快速入门——城市、高校、专业通通一文读懂！	
这些公办院校开设了二本专业，实力强，位置佳，任你挑！	
报志愿时城市、专业、学校到底哪个重要？选大学最重要的指标	
北大清华公布今年自主招生初审名单 吉安3名“学霸”被“预定”	
被家长这样“忽悠”长大的孩子竟更优秀	
原创：给中考和高考家长的建议	
不同层次的考生该如何冲刺2018年中考？此文献给五月迷茫的你！	
不同层次的考生该如何应对2018年中考？此文献给五月迷茫的你！	
答疑｜成人高考被录取后怎么上课的？	
独山一中开展“拒绝手机进校园”教育活动	
新高考改革后首次普通高中学业考试5月7日报名	
儿子今年被重庆邮电大学生物医学工程专业录取，了解到该专业的就业前景不好，该怎么办？	
儿子今年高考，看成绩只能上二本，我是花十几万让他上大学，还是让他出去打工？	
二本分数应该选择热门专业争取考研到一本，还是选择好就业的专业掌握技术直接就业？	
分数过批次线20分，为了喜欢的专业，选一本院校好还是省外二本好呢？	
提前祝愿2018年，6月高考的你们顺顺利利！	
谁说你不能是高考逆袭的那匹黑马	
茂陵博物一日游	
五一小长假，开元寺半日游	
旅游攻略 走进孜州海螺沟景区	
东京一日游jr交通卡买哪种？	
北川九皇山景区 震后十年重生	
德云山综合旅游区一日游最全攻略	
5台新型环保车云阳山风景区上岗	
假期呼伦贝尔草原七日游路线攻略	
北川九皇山景区十年涅槃，而今重生	
宝岛基隆一日游，发现海峡对岸的美	
东北三省自驾游8天，有什么线路推荐？	
在加拿大自驾游是一种怎样的一种体验？	
川河盖景区帐篷露营地5月13日对外开放	
5月12日，剑门关景区等你来，重点是……	
中使馆发埃及旅游指南 遇景区人员索要小费应拒绝	
这座城市景区全免费，包括1个5A和7个4A级景区	
呼伦贝尔草原这个景区被称为户外天堂，99%的人都会去	
青天河景区推出“七古”历史文化游 七大古迹你去过哪些？	
5月已通行！阿克苏人能去这条壮美的公路自驾游啦，具体……	
九皇山，用十年时间说一句感谢，数万张景区贵宾券免费发放啦	
免费！九华山、牯牛降……这28家A级景区，安徽人免费玩！	
太牛了！雷台大景区总规划首次大曝光，抢先看多片区效果图！	
投了5个亿，免费的倒回沟景区，成了门票50元的天河大峡谷	
五一自驾游住酒店多留个心眼，提前准备这些东西，安全又卫生	
好消息！炭河古城景区西周风情街只等你来！机会一年仅这一次	
一座城，一湖水，这个4A级景区免费开放，这里的市民有福了	
浙闽两省四县相关领导签署了（龙头山）景区旅游开发合作备忘录	
去闺蜜家，被院子里的花吸引住了，都要爆院了，简直比景区还要美	
喀旅股份“喀纳斯景区旅游咨询引导员正式上岗竭诚服务为游客解难	
令人震撼的三大景区，其中一个景区青山常绿、河流密布、风光绮丽	
「免票了」5月19日，达古冰山景区免门票，老铁们提前安排一下	
山沟沟几年前随便玩，现公司开发为4A景区，半年收入5600万	
江南六大古镇之一-同里古镇（小桥流水人家）第八章 珍珠塔景区	
这4个旅游景区堪称“山寨之最”，最后一个门票七百多，感觉最坑	
全部实拍图，武汉一景区内近十种鲜花相继盛开，一年最美季终到来	
好消息！九华山、牯牛降、秋浦河……28家景区，马鞍山人免费玩！	
房产租售服务	
拆迁注意事项1	
二手房好卖吗？	
房贷利息会涨吗？	
房地产成本核销三	
房地产调控不能懈怠	
旅游房产前景如何？	
房产销售入门三步走	
我们该不该变房奴？	
二手房值得购买吗？	
公积金贷款的利与弊	
你现在拥有几套房产？	
现在该不该投资房产？	
房地产成本核算课程二	
房贷审批需要多久呢？	
房贷利息是怎么算的？	
这房子，难怪房东要卖	
现在做房产销售如何？	
房地产开发商团购公司	
房地产税改革渐行渐近	
二手房可以按揭贷款吗？	
房产证上加名字大有学问	
二手房交易涉及哪些税？	
店铺房东大幅涨租金对策	
子女如何继承父母房产？	
租房市场同样不容“炒”	
房产的大火还能烧多久？	
拆迁房屋价格评估的程序	
买二手房需要什么费用？	
购买二手房，卖家反悔？	
住房公积金会不会被取消？	
如何避免二手房交接纠纷？	
如何省钱买房不做房奴呢？	
如何签订二手房买卖合同？	
做房产到底逼疯了多少人！	
二手房翻新需要注意什么？	
二手房买卖应该注意什么？	
凭什么我要分一半房产给你	
现在办个房产证需要多钱？	
父母的房产如何办理继承？	
房贷年龄限制延长至70岁	
拆迁，这样补偿合法合理吗	
商业房贷如何转成公积金贷？	
为什么现在银行不放房贷了？	
租房买房要小心房源“陷阱”	
2018年做房地产怎么样？	
主城区棚户区改造三年内完成	
首套房贷上调 购房族再添难	
长租房是未来的趋势所在吗？	
居民一次收到6次房地产税单	
办理房地产资质有什么条件？	
探讨：售楼处如何缴纳房产税	
2018更适合买二手房吗？	
没有房产证的房子可以买吗？	
公租房什么时候能办房产证？	
直戳痛点，买房与租房的区别	
网上提取公积金需哪些步骤？	
在外租房要记住这些注意事项	
房贷为何不能自己选择银行？	
把房子租出去还房贷划算吗？	
可以使用公积金在异地买房吗？	
为什么房价涨了二手房卖不动？	
未来房地产调控会持续加码吗？	
公租房和廉租房能否长期租住？	
公积金贷款买房有哪些优缺点？	
工行试点推出房租分期付款业务	
今起提取公积金不需复印身份证	
退役军人如何申请公积金贷款？	
房地产销售真可以月薪过万么？	
哪些人在租房市场“炒租金”？	
现在哪些城市还可以投资房产？	
在东京基本只能租房过日子吗？	
有30万，如何选对房产投资？	
90后，还完房贷是什么感觉？	
期房没建好就要还房贷合理吗？	
交了首付房贷批不下来怎么办？	
二手房不砍价，中介当你是傻子	
拆迁维权的最佳时机和应对措施	
防止提取住房公积金用于炒房投机	
买新房环是二手房，帮您分析以下	
公司不为员工交公积金是否违法？	
新房pk二手房究竟有什么吸引力	
房产经纪人都要上的房产微营销课	
二手房选购攻略 外部环境需重视	
买新房？二手房？记者帮您来盘算	
与异性合租是一种什么样的体验？	
美国房产经纪人是一个怎样的存在	
你还不知道住房公积金的用处吗？	
警方提示：购买二手房之防坑攻略	
只要满足条件租房也能用上公积金	
房产中介帮同行偷逃税款获刑6年	
申请廉租房容易，该如何退出呢？	
租房坑很多，如何避免租房被骗？	
父母协议离婚房产归儿子可以吗？	
二手房交易契税 未来将可网上办	
买卖二手房，为什么要通过中介？	
买二手房后如何全额取出公积金？	
二手房买卖遇到毁约 该怎么办？	
2017年的房地产销售怎么样？	
廉租房到期后，会出现什么情况？	
为什么要不断提高房贷首付利率？	
房地产开发商一座楼盘赚多少钱？	
符合这13种条件才能提取公积金	
住房公积金，没房贷，怎么提取？	
该不该把房产证写上孩子的名字？	
租房市场——也要“被炒起来吗？”	
房产中介玩猫腻，检察监督动真格！	
贷款买房，几年内还清房贷最合适？	
父母协议离婚，房产归儿子可以吗？	
房地产对经济的影响究竟有多大呢？	
大家租房一般是通过什么渠道找的？	
泰国房地产的“黄金十年”已经来临	
政策持续加码 房地产市场平稳下行	
二手房量价齐涨 市场活跃度升高？	
如何查询名下房产是否给法院查封？	
我市加快推进 非住宅商品房去库存	
工行在蓉试点推出房租分期付款业务	
银行流水的余额少会不会影响房贷？	
三四线城市房地产未来走势会如何？	
炒房团9个月内投资1.2亿赚2亿	
为什么部分城市新房比二手房便宜？	
登记在孩子名下的房产究竟是谁的？	
70W的二手房过户需要多少税费？	
如何判断哪里是今年房产投资的洼地？	
行百里者半九十 房地产调控不能懈怠	
港澳台职工如何使用住房公积金贷款？	
现房和期房的区别 现房有哪些优势？	
房地产市场持续繁荣对我们有何影响？	
离婚房产合同改名需要准备哪些资料？	
临泉人购买二手房的流程及注意事项！	
买了这十种二手房 想要转手可就难了	
商品房对外销售，需要达到什么要求？	
房子房贷没还完，可以把房子卖掉吗？	
买房子交了首付后交不起房贷怎么办？	
没有房产证的商品房您是否住着安心？	
旅游房地产和普通房地产有什么区别？	
楼市风向突变，这条炒房之路被堵死！	
2018年四月，房地产大事件盘点！	
租金高涨，让租房子者后悔没早当房奴	
开通网上业务职工办公积金“零跑路”	
房地产策划能转行干什么工作比较好？	
业主必读：房产证相关的5大法律常识	
炒房团如何炒高了三四线城市的房价？	
房地产降温进行时：房贷利率又涨了！	
房贷30万，贷30年的利息是多少？	
律师解读：商品房买卖合同有哪几种？	
市住建局多措并举加强商品房销售管理	
2018年第二份兼职——售楼部拉访	
如果你是90后，你是买房还是租房？	
直系亲属房产过户，哪种方式最划算？	
抓住这些风口，房地产还会有黄金十年	
买房是买二手房好还是买一手房好呢？	
楼面价9100，商品房售价是多少？	
恋人共同购房，分手后房产如何划分？	
炒房客：我们不炒房，我们只是在理财	
如果房地产价格下降，会出现什么情况？	
房地产繁荣对居民消费的挤出效应有多大	
公积金新变化：单位公积金缴存比例降低	
房贷月供占收入的比例为多少？你知道吗	
教你如何公证房产，还有收费的注意事项	
二手房有价无市，价格为什么这么坚挺？	
没有工作，你怎样做才能申请到房贷呢？	
单位公积金缴存比降低，对你有好处吗？	
楼市政策大调整！又一炒房之路被堵死了	
我省发布住房公积金2017年年度报告	
二手房避坑指南，一定要收藏的购房攻略	
其实，“焦虑的”不仅是购房者｜七大妈	
租房那些事儿：妈妈，房东咋想的啊你说	
婚姻状态变化会影响住房公积金贷款么？	
99%房产归女方，难道婚姻法又改了？	
我市四部门联合开展房地产市场专项检查	
公积金如何按照还款能力计算贷款额度？	
购房者注意！市场上这几类房子很难转手	
中小房企突击上市，抢夺房地产最后门票	
没有房产证的房屋进行交易是否犯法了？	
教你怎样一眼看透房产介绍中的隐藏信息	
80%的购房者都忽略了一个重要指标！	
超四成90后表示接受终生租房？你信吗	
拥有三套房产的我，日子过得却紧巴巴！	
买的二手房，过户和交税需要多少钱呢？	
为什么房东都喜欢把房子交给中介出租？	
买房时怎么从商业贷款转向公积金贷款？	
二手房抵押贷款，真能贷款70%额度？	
关于拆迁补偿款，你必须要知道的几件事	
二手房缴纳定金 务必做到“四核实”！	
商业大佬“租房”也不“买房”的原因？	
去售楼处看房 这四点信息千万要了解清楚	
住建部：防止提取住房公积金用于炒房投机	
四部门发文：优先支持提取公积金支付房租	
绝版宝地百井坊拆迁9年后终于要“出嫁”	
买房需谨慎 到售楼处必须弄清的几个问题	
网络问政如何用配偶公积金冲抵住房贷款？	
楼市调控逐渐收紧，炒房者应该知难而退了	
史上最拼的购房者，98岁还去摇号买房！	
苦盼房产证10年一纸“通知”搅乱业主心	
公积金又有大变化 关系到你口袋里的钱！	
业余炒房团9个月内 投资1.2亿赚2亿	
房奴要注意了！月供占收入比例多少合适？	
如果房贷还不上了，会发生哪些严重后果？	
拆迁补偿要钱好还是要房子好？看情况而定	
二手房定金是什么？交定金时要注意什么？	
炒房团的”足智多谋”,远远超过你的想象	
置业难，租屋也难，荷兰房屋租赁价格昂贵	
没有房产证的房子可以买吗？有没有风险？	
炒房兄弟团队9个月内投资1.2亿赚2亿	
棚户区改造全面推进，优质地块呼之欲出！	
二手房量暴增，降价100万竟无人问津？	
二手房你会买吗？详解二手房交易注意事项	
租商品房提取公积金限额提至21600元	
暴风即来！比房地产更可怕的泡沫正在席卷	
恶！1亿炒房赚2亿，这帮人手段又黑又狠	
买房之后，“房奴”们都过得怎么样了呢？	
一个月交350的公积金，可以贷多少钱？	
个人将房产无偿赠与他人，需不需要缴税？	
央行突然降准，房地产会出现怎样的变化？	
购买二手房时，如何查房屋剩余产权年限？	
售楼处的8大惯用销售套路 你中招了吗？	
买房申请房贷被拒 首付款要打水漂了吗？	
没有房产证的房子怎样才能进行合法交易？	
为什么房地产商背着巨额贷款也不着急卖房	
申请房贷买房后 多少年之内还清最好呢？	
“股神”巴菲特：说真的，房地产不赚钱！	
房价跌了吗？网友不小心抖出了房地产真相	
房产博弈，已至高点，你的房产还有救吗？	
不买房就不交公积金了？先看完这5点再说！	
为什么好多人不喜欢买二手房，有哪些原因？	
房地产咨询：为什么有首付钱都去买房去了？	
北湖十六峯｜精美售楼处，随手一拍都不得了	
公积金小知识：符合啥条件可以公积金贷款？	
购房百科：二手房贷款时应该注意哪些细节？	
海州棚户区改造最新进展！这个地块拆了……	
警惕：假房东“借鸡下蛋”，租房诈骗套路深	
二手房如何查询房龄？房龄过老有哪些影响？	
各城二手房成交大幅回升，新增供需全面增加	
一手房VS二手房，菲律宾房价以及回报问题	
如何查询二手房房龄？二手房房龄有什么影响	
为什么房价上涨这么快？炒房团手法惨不忍睹	
房地产投资时代并没有结束，你的机会来了！	
如何选到小区环境好的二手房？要考虑什么？	
夫妻之间的房产赠予行为，离婚时能反悔吗？	
如果多数人三年不买房子，房地产会崩盘吗？	
租房时代真的来临了吗？租房能否代替买房？	
曾经的房产福地，一个改变就会变成投资泥潭	
各楼层的优缺点是什么？购房者一定要知道！	
拆迁真的可以暴富吗？看看各地网友如何说的	
去售楼处看房：购房者应该看什么 问什么？	
房地产税推出前是否应该把多余的房子卖掉？	
名为房地产合作开发实为用地补偿合同的处理	
2018年到底是不是房地产全面下跌之年？	
银行停止房贷，只能全款买房，房价会如何？	
四招教你买到优质二手房，内附省钱必杀技！	
房产的网签是什么意思？网签的流程有哪些？	
买房遭遇“一房二卖” 购房者应该怎么办？	
违规要求买房人提供证明，部分开发商被约谈	
房地产企业拿地热情降温 盈利空间持续受限	
安置房和商品房的区别有哪些？千万别买错！	
房地产时代过后，下个投资回报高的是什么？	
房产税与房地产税的一字之差，你知道多少？	
购买二手房的时候怎么避免买到“凶宅”呢？	
租房信贷试点逐步推进：长租公寓插上金融翅膀	
购房者该不该买房？哪些因素会影响房贷年限？	
现在买房去售楼部都说卖完了，究竟谁买的呢？	
4亿多房奴的焦虑：除了房子，你还剩下什么？	
多部门联合下发通知 严打违规使用公积金行为	
住建部等四部门发文 严查违规提取住房公积金	
住建部等四部门：防止提取住房公积金用于炒房	
你身边拿到拆迁款的朋友，现在是怎样生活的？	
商品房隔音差，有什么好的办法加强隔音效果？	
婚前房产婚后拆迁，安置房属夫妻共同财产吗？	
地产早讯：2018年5月9日房地产最新动态	
昨晚，楼市政策大调整！又一炒房之路被堵死了	
历史上都有哪些国家发生过大规模房地产泡沫？	
买二手房要办哪些手续？有哪些要注意的事项？	
如果意外死亡，他的公积金和社保能取出来吗？	
买商品房时 商品房制式合同可以更改条款吗？	
购买的商品房办理房本，用去公证处做公证吗？	
8个购买二手房的注意事项 购买时要擦亮眼睛	
现在，房地产饱和了吗？房子是剩余还是紧缺？	
一张纸让整栋租客不安！房东永远不懂的苦……	
商品房预售合同纠纷中，购房方为什么难赢2？	
在国企工作了六年，应该辞职去做房产销售吗？	
该来的一定会来，房产税让炒房的人瑟瑟发抖！	
一句话楼市：二手房交易契税 未来将可网上办	
人民日报罕见发声高价租房 万科预租再惹争议	
我省去年发放公积金个人住房贷款7.58万笔	
「房产」预计2018年房屋交易量将再创新高	
专家热议房地产资产证券化：为房企带来新机遇	
《地产四十年》：1979第一栋商品房的落地	
婚后父母为子女出资购房，离婚时房产如何分割	
房贷的计算公式到底怎么算，计算公式又是什么	
炒房客和开发商抢先抛售房产，楼市泡沫将不远	
请问住房公积金每年可以取一次吗？怎么取的？	
回迁房比同楼盘的商品房便宜一半，要不要买？	
装修二手房不简单，但是购买二手房更加不简单	
购买二手房后，对方不迁走户口，我该怎么办？	
无证不等于违建，拆迁遇到这种情况你要注意了	
购房者又多付钱 北京银行再上调首套房贷利率	
有没有想过突然有一天房贷真的还不上怎么办？	
价格相同，是选择一套别墅还是两套商品房呢？	
90后的住房观调查：超四成表示接受终生租房	
“棚户区改造进入征求意见阶段”是什么意思？	
还完房贷别忘了这步!去银行解压拿回“欠条”	
如果大家有钱的话，会选择把房贷一次还清吗？	
住房公积金部分业务改革，只用于偿还贷款本息	
法律｜买二手房一定要网签吗？不知道会吃大亏！	
速看：单位公积金缴存比例降低 对你有这些影响	
住建部重申坚持调控不动摇 各地或酝酿房产新政	
一讲就懂：婚后取得房产，不一定就是共同财产！	
九成“房奴”应注意！焦虑情绪或正在毁掉你……	
父母给子女买房3点须牢记，否则房产就归别人了	
买个90平米的二手房，买方都需要交什么费用？	
二手房买主是否能够向开发商主张承担赔偿责任？	
3-5年后，买房的人和租房的人差距到底有多大	
中小房企慌了？密谋突击上市 夺房地产最后门票	
本人30岁，房贷和车贷压力好大，该何去何从？	
绿地控股：4月所获房地产项目斥资67.38亿	
5月新房摇号“狂欢” 二手房成交“整体平稳”	
房产惊人消息！楼市调控根本不是为了控制房价？	
CitySpade大盘点｜LA租房攻略送你了	
离婚时房子怎么分割？5种夫妻离婚房产分配情况	
新房和二手房，你需要知道的区别都列在这里啦！	
30个热点城市房价一览！新房二手房一目了然！	
开发商要求购房人自查买房资格 房管局怎么说？	
取公积金需要什么材料2018取住房公积金流程	
月薪1.2万，房贷1500元，适合买什么车？	
买房扫盲：选对房贷少奋斗10年，你选对了吗？	
房贷45万，20年期限，等额本金，月供多少？	
你敢买高龄的二手房吗？看看利弊再做定论吧！！	
为什么正常人家装修装不出售楼处样板间的效果？	
公积金贷款了解一下，不需要收入证明、银行流水	
拆迁安置房可以办不动产权证吗？这下有答案了！	
工资6300房贷3200，可以买什么样的车？	
全国有20家银行停止房贷是真的吗？怎么回事？	
老人房产在生前或去世后过户给儿女有什么不同？	
胡乱提取住房公积金，可能让你的买房计划泡汤！	
当房奴这么痛苦，为什么很多年轻人还贷款买房？	
租的门面房被房东抵押贷款了，对我们有影响吗？	
调控越来越严，为何仍不见炒房者大量抛售房子？	
买二手房除了房子首付，你还要准备好这些费用！	
全民疯狂炒房，房产税抑制房价？专家：不可能！	
房贷额度“缩水” 首付已交无法退房该怎么办？	
「购房问答」提前还掉50万房贷 还是再买一套？	
租房者享受生活：与其当房奴 不如给生活更多可能	
「案例研究」我国离婚财产纠纷中涉外房产如何处理	
房贷利率飙涨楼市回暖 炒房团再出手欲抄底翻身？	
小伙婚前全款买房 离婚时99%房产被判给女方！	
小猪砸2.7亿又买内湖豪宅 坐拥5亿房产等娶妻	
3-5年后，买房的人和租房的人差距可能有点大！	
有20万存款，想买个房，是买新房还是二手房好？	
图解：租房与买房的区别，生活差距没想到这么大！	
月入过万的房产中介都在用：理光全景式4K相机！	
六座城市将实行“共享住房”，彻底告别房奴时代！	
小伙婚前全款买房 离婚时99%房产却被判给女方	
房东签了合同收了23万房款却不卖了 法院怎么判	
谨防拆迁补偿协议骗局，这样签才能获得满意补偿！	
楼龄老价格低的二手房，建不建议买呢？要考虑这些	
买房选择几梯几户的房子最好？房产专业人士来解答	
住建部等四部门：防止提取住房公积金用于炒房投机	
用20~30年还房贷愚蠢吗，或者说买房愚蠢吗？	
单位公积金缴存比例降低 专家：对职工没太多好处	
政经谭｜住建部：防止提取住房公积金用于炒房投机	
房地产翻倍涨价，实体经济却不好做，你怎么看待？	
4月，这两区的二手房竟比新房贵？真的是这样吗？	
惊心！炒房团如何短期内把三线城市房价炒高两三倍	
买房人必看！史上最新最全的公积金贷款攻略来了！	
曼谷素坤逸地区持续发力，领跑泰国全域房地产市场	
售楼处；当涂家天下售楼处地址；家天下售楼处电话	
小县城二手房量价齐跌，炒房客三倍杠杆直接套牢！	
人民日报评万科翡翠书院项目：租房市场同样不容炒	
公司帮购买公积金，但要全部从工资里扣是否违法？	
在现在的调控政策下，炒房者会不会大面积抛售房子？	
炒房团两亿元买整栋楼，你现在买房是投资还是接盘？	
房产中介喝醉了，说了3句心里话（震惊整个朋友圈）	
住建部约谈12城重申坚持调控不动摇各地或房产新政	
错过了4000多的房子，还好老房子等到了拆迁……	
注意啦！提公积金不再需要身份证、结婚证复印件啦！	
住建部：延长降低企业住房公积金缴存比例政策执行期	
房贷25年，已经还了5年，剩余的提前还清划算吗？	
骗称有“指标房”，房产经纪人框走30万供自己快活	
“制定房地产税法”再被列为人大常委会预备审议项目	
二手房买卖骗局大揭秘，新手必看，不看你千万别后悔	
房地产和B特币一对比 你就知道真正的泡沫长什么样	
炒房团、房产中介、媒体联手刷房价，9个月净赚1亿	
房子被限制购买后，购房者怎样才能拿到买房资格呢？	
房贷申请下来之后，偿还房贷期间需要多注意这些地方	
房价是怎么涨上去的？其实就是购房者自己抢上去的！	
买方银行房贷久久批不下来，卖方有权收回重新卖吗？	
五月开局购房需求旺盛 首周商品房供应面积环比大降	
出国留学，除了在学校宿舍住，还有那些租房的选择？	
炒房泡沫市场以湮灭，国家给了他们最稳的一波电梯！	
房地产税改革渐行渐远 从立法到落地仍有一段路要走	
刚需最新利好：全国商品房供应将提速，房价有望企稳	
善言：房东有权不退押金吗？遇房东苛扣押金怎么办？	
昨晚，楼市新一轮政策大调整！这次炒房之路被堵死了	
夫妻购房合同签谁的名，以后房产证就是谁的名字吗？	
军人住房公积金贷款办理程序有哪些？一条微信告诉你	
房产证上到底可以写几个人的名字？大多数都理解错了	
2018年申请廉租房都有哪些条件 这几点很关键？	
2018年一旦买了这7种二手房，过户将遥遥无期！	
名下只有一套房，如果房贷断供，房子也会被收走吗？	
离婚房产能分割？公积金也能分？竟然属于共同财产！	
房价一年翻一倍，三四线城市炒房，发展趋势怎么样？	
想卖房子的注意啦！揭秘房产中介​委托卖房的漏洞！	
被撩起的三四房地产，收割的是中产阶级还是老百姓？	
房东签了合同收了23万房款却不卖了，法院怎么判？	
买二手房应该注意什么？和中介沟通还要注意什么呢？	
买二手房已经过户等待银行放款，应该没有变数了吧？	
房贷假如要提前还款，等额本息和等额本金哪个划算？	
买房子是买市中心的二手房好还是买偏一点的新房好？	
租房还是买房，90后的梦想是否真的会毁在房子里?	
公积金新变化：单位公积金缴存比例降低 对你影响多大	
地震后房子没了，房贷还要继续还吗？答案万万没有想到	
俄罗斯地域辽阔，如果发展房地产会怎么样，能崛起吗？	
20年前的房产广告！看完不止扎心，全身都扎遍了……	
住建部等四部门联合发文 防止提取公积金用于炒房投机	
现在泰国房产适合做投资吗，应该如何做泰国房产投资？	
70后，80后，90后，三代人告诉你，谁才是房奴？	
2018二手房继承过户会产生哪些税费？你需要了解下	
当下房产还值得投资吗？大佬们说：这五类物业还有机会	
用20~30年还房贷，或者说买房是件愚蠢的事情么？	
套路贷新套路：挑有房者下手 有人900万房产险被套	
小伙婚前全款买房 离婚时法院却把99%房产判给女方	
确认过数据，这份2018房地产市场报告地产人必备！	
房地产和B特币一对比，你就知道真正的泡沫长什么样！	
公积金贷款买房务必远离这6大谣言，否则很容易失败！	
房贷240万，房价200万，断供弃房就能万事无忧？	
今年房地产调控已达109次，周期板块还能迎来春天？	
“扶我起来，我要还房贷！”｜高房价下，该何去何从？	
婚前房产约定的正确姿势，99%房产归女方 丨小资家	
触目惊心！炒房团如何短期内把三线城市房价炒高两三倍	
买二手房，卖方不到场房子委托公证也能买，你知道吗？	
对方借了我的钱不还，为什么他有房产也不能强制执行？	
买二手房时，黑心中介最怕你检验这5处，一查一个准！	
他做了一款“租房+社交”应用，大数据匹配国民好室友	
房贷申请下来之后，偿还房贷期间需要多注意这些地方！	
2018年公积金贷款或省几十万！这的人离婚需谨慎！	
新生人口减少，房地产该如何发展，未来的价格会降吗？	
我来向大家揭秘，内地某大房产中介是如何自己炒房的。	
公积金贷款买房请留意这6个细节，否则就等着被拒吧！	
买房的注意了，这张纸比房产证还重要，很多人却不重视	
房贷利率上涨，为何银行对房贷出现180度态度转变？	
关于公积金的提取：看以下12点有没有符合你的提取条件	
公积金新变化：单位公积金缴存比例降低 对你影响多大？	
新变化！单位公积金缴存比例降低 对你影响多大？速看！	
2018，违约潮袭来！实体经济或比房地产更早扛不住？	
全民房奴时代来临！70/80/90的买房人过得如何？	
56家银行暂停发放房贷，为何终于凑够首付却贷不到款？	
有钱人从不买二手房，听完内行人分析，还好我家忍住没买	
专业炒房团投资1.2亿9个月赚2亿：赚钱从未如此轻松	
9个月内投资1.2亿赚2亿，炒房团真是在爆炒房价啊！	
楼市又曝重磅消息，房贷率被上调，房价难道还会涨下去？	
美联储加息对于已经买房正在还房贷的人群有什么影响吗？	
买房和没买房到底区别有哪里？我们到底该买房还是租房？	
用 20~30 年还房贷，或者说买房是件愚蠢的事情吗	
买二手房务必尽快完成过户，否则很可能面临这5大后果！	
如果父母死亡，名下的房产子女一直不去过户，会怎么样？	
如果按现在的房地产销售面积销售十年，会出现什么结果？	
毕业了该去哪儿？各地人才引进购租房政策清单，来一份！	
租房合同里隐藏的九种不公条款，条条扎心，千万别中招了	
女子司法拍卖买下精装二手房 房主离开前疯狂破坏遭索赔	
「拆迁周刊」拆迁评估中的那些坑，这样做保你顺利避开！	
解决这4个问题，房地产税就到来了，房子是不是该降价了	
买了学区的期房，孩子即将上学，拿购房合同可以入学吗？	
房产中介隐瞒交易对象是其员工 构成对委托人利益的损害	
商铺拆迁怎么赔偿？读懂这12句话，没人能忽悠得了你！	
银行房贷放款越来越慢，着急死了！3招教你提速房贷放款	
2018年若是遇到这些情况，就赶紧把房贷提前还了吧！	
买房必看！315维权投诉最多的8大房产问题及应对方法	
新房和二手房的八大区别！年后新手别再纠结买房这回事！	
警惕！拆迁面积算错，你的补偿款正在悄然“缩水” ……	
长点心吧！房产证最好不要写孩子名字，要不后悔都来不及	
什么时候买房不赔本？老司机说漏嘴了七大房产投资契机！	
房子付了首付也过户了，房东突然表示不卖了，该怎么办？	
出现这三大信号预示你的房子要贬值！购房者注意到了吗？	
离婚后住房公积金归谁？ 是个人财产还是夫妻共同财产？	
房产登记在孩子名下的中国式买房，以爱之名，惨中数招！	
房产证上加名：父母、配偶、子女，如何操作？一读就懂！	
房地产税将至！是山雨欲来风满楼，还是炒房时代已到头？	
还完房贷还有一个步骤要走！如果忘了房子依旧不是你的！	
存缴住房公积金6个月，每月1140元，可以贷多少钱？	
消灭高房价的方法找到了！只需一招，炒房投机客一网打尽？	
城市房产风云再起，数位负责人相约谈话，究竟卖的什么药？	
买房就注定成房奴？一辈子为银行打工？是时候改变观念了！	
婚后房产一定是夫妻共同财产？长点心吧，不然一半房产没了	
出卖商品房上设定抵押权情形时买受人如何主张自己的权利？	
「房产汇」楼市调控仍在持续，三四线城市房价将何去何从？	
2018年买二手房怎么过户？买二手房过户费需要多少钱？	
业余炒房团投资1.2亿9个月赚2亿：赚钱从未如此轻松！	
住建部：降低企业住房公积金缴存比例政策延长至2020年	
为何很多人不愿意买二手房？内行人说出真相，懊悔没早知道	
只有购房合同和发票，地产公司被注销了，怎么办理房产证？	
「拆迁周刊」房屋面积“打折”，补偿上不去，你该这样办！	
各大城市人才都抢光了之后，未来多余的商品房该如何消化？	
买房千万不能贪小便宜，三产、拆迁安置房再便宜也不能买！	
为什么开发商交房后，还要等360个工作日才能办房产证？	
对待家暴男这法子凑效：房产给我99%就可以了，给你1%	
多个城市这个数据创纪录，购房者：这房价还有机会下跌吗？	
炒房团神操作，用1.2亿赚2亿，利用中介和媒体炒作房价	
“小产权房”比普通商品房便宜那么多，我们到底要不要买？	
小伙婚前全款买房 离婚时却判房产99%归女方 原因是？	
城市房产均价排名前10一览，你所在的城市房价是多少呢？	
注意！用公积金贷款买房是职工法定权利，开发商不得拒绝！	
离职银行柜台人员透露：这么申请房贷，可以节省一大笔钱！	
买房投资暴利时代结束，这或许就是国家给炒房者最好的台阶	
人民日报发话“租房市场同样不容‘炒’，释放了什么信号？	
首次懵懂，二次惆怅，阶梯置业中的购房者到底该如何选择？	
2018公积金提取新政来了，别让你的公积金一直睡大觉！	
如何评价在地级市，2000一平买了套120平的二手房？	
为什么我的房屋一夜之间成了棚户区，拆迁补偿有什么影响？	
申请房贷前都需要准备哪些工作？记住这4点轻松搞定房贷！	
拆迁补偿协议“应当”怎么签？（附房屋拆迁补偿协议范本）	
2018年房贷年限不满30年？那你一定存在这5大原因！	
开发商焦虑、作死、赌气！这3个现象看清当前的房地产市场！	
把公积金里的七万取出来付首付，再用公积金贷款还贷可以吗？	
30岁买房，55岁时需要第二次买房，65岁无可奈何去租房	
假如房价下跌如山倒，房产多的还能笑多久？以后怕是要哭了！	
家有空置房产的看过来！空置或废弃房产将缴纳三倍市政房产税	
2018下半年，房价若再次上涨，多数房奴难逃这5种命运！	
现在的二手房房东，为什么等了很久都卖不掉房子？原因很简单	
三四线城市的二手房早已卖不出去？2018年房价会“降”？	
房价不会大涨大跌，需要则买，不需要想炒房的话还是及早远离	
人民日报挺万科“十年180万房租”：房租可以涨，但不能炒	
为什么聪明人从不买二手房？听完内行人一说，懊悔知道晚了！	
当年若我信了房地产中介说房子会涨价的事实！现在将会怎样！	
房地产开发企业在销售不动产过程中代房管部门收取了维修基金	
二手房一天涨价15万，在高收益面前，诚信已经变得一文不值	
2018二手房继承过户会产生哪些税费？不知道可要误大事！	
在房子贷款未还清的情况下，能否在房产证上增加他人的名字？	
租房合同到期，租户恶意不搬，房主是否可开锁强行收回房屋？	
近期准备买房的青岛人速看！公积金有大变化！下月起施行……	
三四线城市房价暴涨，炒房团获利丰厚，一起看看网友们怎么说	
想一次性提取公积金全款买房需要注意哪些事项，才能快速办理	
这些比房产证还有用的纸弄丢了要吃大亏！看看你的还在不在？	
租房合同到期，租户恶意不搬，房东强行开锁收回房屋违法吗？	
房地产市场三：是什么支撑的房屋空置率那么高，房价还这么贵	
这个小本子，比房产证重要的多了！有了这个证房子才是你的！	
今年起，父母为孩子买房要注意这几点，否则房产就归别人了！	
房地产真的完了？年薪50万销售跳槽文职——月薪仅7000	
房主为了防止租户做二房东，必须注意这2点，否则视为默认！	
不管房价涨跌，只要你不是炒房投资，2018看准6点买房！	
婚后房产一定是夫妻共同财产？长点心吧，要不然一半房产没了！	
俄罗斯这么大的地方，如果发展房地产会怎么样，能重新崛起吗？	
新婚姻法离婚房产规定如何分割？分居两年判决离婚财产怎么判？	
手中资金大约600万闲置资金，房产已限购，该怎么配置投资？	
城市宽松落户想称借机炒房？！不！变相松绑限购，可能性很小！	
住建部等四部门开展治理工作 防止提取住房公积金用于炒房投机	
调查发现-房产中介、业主投资客、炒房团是这样让房价涨起来的	
未来房价可能会跌40%, 根本卖不出去，或全砸在炒房人手中	
专家：城市化结束，房价下跌！房产界巨头们都忙着变卖房产了？	
年轻人超4成选择终生租房，你是否愿意这样选择只租房不买房？	
党报谈10年租金180万释放了什么信号，你还敢炒房炒租吗？	
交了首付没签合同的期房，房主要卖，双方还用交其他的费用吗？	
房产大佬：留给高房价的时间不多了！这一次，被打脸的会是谁？	
二手房贷款怎么办理？交易税费怎么计算？什么样的算是二手房？	
房产继承？离婚时房产分配？孩子的抚养权？现身说法为您解答！	
购买学区房原房主未迁户口怎么办？警方提示如何顺利购买二手房	
婚前房产证一个人单独所有权，婚后加对方名字，算共同财产吗？	
2018新规：父母给子女买房3点须牢记，否则房产就归别人了	
怎样看待2018的房地产市场，京津冀城市群迎来哪些新变化？	
傻傻的你，不要买了房子还替别人数钱!教你如何鉴别房产证真假	
奇怪了：坐拥百万房产却月收入可怜的人，属于中产还是穷人呢？	
买房后这3张纸比房产证还重要，千万别弄丢了，别等用时才后悔	
全款购买一套二手房，合同已经签了，现在房主反悔，该怎么办？	
房产证抵押贷款还款如何进行？在我国买房子交税需要什么手续？	
58同城上个人发布的租房房源信息，为什么总是仅限女生租房？	
想选的房子是期房，能看到的整体就是沙盘模型，要着重看哪里？	
房产证也能造假？五大技巧让你避免买房被糊弄，不懂得都记住！	
拆迁一夜暴富，可是拆迁的流程你知道吗？万一你的好运降临呢！	
我市召开房地产市场管理工作会议，启动房地产市场重点整治行动！	
未来的房地产市场将会怎样发展，有哪些因素制约房价，你知道吗？	
买房西朝向的户型好不好？售楼部老同学道出真相，一概而论错大了	
购买商品房公摊面积达25%，业主有权向开发商索取公摊数据吗？	
继承公证书缺继承人，受益人用公证书过户了房产，该怎样追责呢？	
「案例」触目惊心！炒房团投1.2亿赚2亿 炒高房价后卷钱而走	
哪件事，深深地刺痛了“租房”的你？网友：爸爸，又没地方住了吗	
房产界大佬又语出惊人，房地产不愿意拆穿的秘密，怕房价跌下来？	
拆一赔一还是拆一赔二？拆迁户和征收方眼中的拆迁补偿标准不一样	
他有六套房，谁也不敢买！6本房产证其实是一套房！谁买谁掉坑！	
换工作后，新的工作单位不给缴纳住房公积金，住房贷款该怎么还？	
奇怪了：房地产官方数据与实际情况严重不符，到底是谁出了问题？	
房子紧张？98岁老太抢房了，no！接下来商品房供应有望大幅提	
买房子一次性付款限制年龄吗，房产抵押消费贷款有哪些相关内容？	
面对开发商的“一房二卖”，购房者如何更好地维护自己的合法权益	
当兵福利这么好？	
卡罗拉州航母展览馆	
解放军绕岛巡航点名台湾	
美国的反航母手段有哪些？	
澳大利亚的军事工业怎么样？	
印度电磁轨道炮是什么水平？	
为什么美国人很少举行阅兵？	
直击：美军手里的越南女战俘	
美国E-2D预警机有多先进？	
为什么二战日本会偷袭珍珠港？	
美国：一男子用退役战机造快艇	
美帝飞机资料（AC-130）	
为何美国坚称原子弹下无冤魂？	
美军为何下令禁止使用大疆无人机？	
叙利亚遭遇空袭 如何对抗巡航导弹？	
接到赴叙利亚参战命令两千俄军递交辞呈	
俄罗斯女兵爱戎装，引得男兵不得不仰视	
像美国那种十万吨的航母会被海浪掀翻吗？	
冷战时期世界上的两个大国是哪两个国家？	
意大利空中悍将——A129 武装直升机	
老照片：1955年，“协防”台湾的美军	
真实西伯利亚训练营！专产世界最凶悍战士！	
假如美国全部航母出动可以携带多少舰载机？	
俄罗斯未来真的会出售图-160轰炸机吗？	
伊朗为何坚持要买俄罗斯的苏-30战斗机？	
我军再获新科技，运9重型翼，系统亮相高原	
中子弹有多厉害？美国为什么放弃氢弹？（二）	
美国F-22被击落！竟然是这个国家战机所为	
霸气！伊朗直接向美航母开炮，并且拒绝道歉！	
印度坦克开发新功能：安装座椅当高级军官座驾	
美国军官、军士退役时能否花钱把配枪买回家？	
印军“反恐”中缴获了一杆稀罕步枪，中国货？	
美国F16生意被抢，枭龙战机将迎东南亚买家	
苏57露出真面目，俄罗斯将会阅兵首秀五代机	
美国12万吨核动力航母能不能抵挡海啸袭击？	
抗战谜团：为何中国一个军打不过日本一个师团？	
德国二战时唯一下过水的航母，堪称四大顶级航母	
俄罗斯举行胜利日阅兵式 大量先进武器装备亮相	
玩砸了？最强航母福特号再出故障，被迫返港维修	
赴雪海、战天险！新战士能否完成首次全线巡逻？	
美国测试可以击毁无人机的新型微波（激光）武器	
俄罗斯的阅兵彩排中，女兵头戴大红帽，十分抢眼	
国民党轰6千亿买军火 为“台独”打仗命值多少	
解放军“绕岛巡航”现新模式 外媒：震慑“台独”	
你怎么看俄罗斯唯一航母要花费60亿人民币维修？	
中美航母战斗群的差距究竟有多大？真相振奋人心！	
越战期间，被美军俘虏的越南女兵为什么痛不欲生？	
阅兵曝光4艘攻击型核潜艇 和美俄核潜艇差距多大	
印度最先进军舰船坞被龙门吊砸了 祸起于一场大风	
超越福特号？003核动力航母排水量超11万吨？	
中巴枭龙战斗机为什么获得马来西亚的青睐？符合国情	
以色列为什么能成为军事大国？是靠什么发展经济的？	
如果俄罗斯没有军事扶植巴沙尔，叙利亚局势会怎样？	
在越南阅兵式中，为什么士兵的胸前佩戴了很多勋章？	
美国的“末日飞机”是用来干什么的？核战后的避难所	
俄罗斯胜利日阅兵总彩排盛况 央视记者带你先睹为快	
海上阅兵检阅舰远洋出征：大洋之上同场pk英法海军	
不考虑核武器，只是常规武器，美国多久能打赢俄罗斯？	
巧妙设计双层护甲，火力无可匹敌的德国产豹2主战坦克	
俄罗斯转盘，手枪对决，是先手有优势还是后手有优势？	
难得一见的美国十二种著名军用（民用）飞机驾驶舱内景	
为搞对抗该国找来印度学习开战机，简直是拿生命开玩笑	
美国女武神超音速轰炸机是什么时候研制的，性能怎么样？	
这款飞机比肩无人飞船，专家称在亚轨道上拥有无限续航力	
俄试射的新型反导导弹，真的能改变美俄反导博弈格局吗？	
美国的军事武器先进到什么程度？是否真的掌握外星科技？	
伊朗以色列开打了！在俄军面前狂轰滥炸，俄军去哪儿了？	
美F-22战机在阿拉斯加附近拦截两架俄图-95轰炸机	
特别的日子，俄罗斯公然亮相大批武器，飞机大炮全体出动	
能指挥美国超级航母的军舰：排水量近两万武器寒酸的巨舰	
以色列防空系统拦截伊朗的中程弹道导弹成功率有多高呢？	
东风反舰导弹特种式弹头：可以钻透美航母所有十四层甲板	
俄罗斯“匕首”导弹服役，像一把尖刀直插美国“心脏”！	
以色列报复性空袭伊朗在叙目标 伊朗以色列爆发直接交火	
印度第一艘国造航空母舰“维克兰特”号质量真的很差吗？	
俄卫国战争阅兵，靓丽女兵最抢眼，民众上街围众多观装备	
美国援助盟友上亿装备，不料仓库爆炸，大批导弹毁于一旦	
《坦克世界》各系中坦特点总结，脑袋最硬的当属S犀中坦	
都错了！美官方证实战机坠毁真相，要求盟友必须给出回应	
俄空天军连出大事！在叙利亚一周损失两架战机，伤亡惨重	
多国联军开到俄罗斯家门口，大批战机已就位，俄罗斯危急	
突发！多名叙高级军官再遭“暗杀大国”复仇，全部身亡！	
二战期间美国如此折磨在美日侨，手段之狠引发全世界争议	
韩国自称在海军方面能够碾压俄罗斯，俄专家：确实有可能	
中美俄三大国六代机到底谁先服役？俄专家这回给出中肯答案	
歼20要造多少架？这个数字难以置信，美国判断失误后悔了	
世界上最大的大炮到底有多大？让你见识下强悍的德国军工！	
美国又不履行合同？战机一再推迟交付，迎来这个国家的抗议	
最快战争，以色列二战坦克对埃及T55坦克，埃及六天战败	
叙政府军彻底急了：S-300还不发货！俄军也在过嘴瘾？	
军队内务中的有哪些难以理解的规定？美国这一规定堪称变态	
抗日老兵回忆，我用重机枪打鬼子是积德行善，长寿101岁	
叙利亚多处军事阵地遭以色列导弹夜袭！叙军方：有人员伤亡	
美国扛不住了！终于开放军用无人机销售，不开放注定被淘汰	
除了HK416型突击步枪，德国还有哪些优秀的突击步枪？	
为什么外国的军舰命名就很美，我国军舰的命名就很“土”？	
被人压制到家门口，F35A已上阵，俄罗斯也要办军演回击	
美精锐特种兵遭遇大丑闻！内部混乱曝光，美媒抱怨浪费军费	
在叙利亚军强大攻势和威慑下，政府纷纷交出了武器，我的天	
伊朗刚发射火箭弹，以色列战机就空袭叙利亚，战争已经爆发	
美国大军压境，这国吹响反击号角：先来轮导弹攻击“练练手”	
1945年美国制造出的第一颗原子弹是利用的什么化学反应？	
以色列警告称如果战机被击落将会轰炸俄军事基地，你怎么看？	
俄罗斯的Space X “能源”无人飞船航天难题得以解决	
未来战争的武器，只要其中一款普及军队，将势必改变整个战场	
德国受到一战的制裁，为什么在短短几年内就能再次发动二战？	
二战日本大和级战列舰，排水量7万余吨，主炮炮弹重1.5吨	
俄罗斯拉开架势要跟美国决战！8艘大船已紧急向叙利亚运军火	
时隔7年美国海军重组第二舰队，美国真正目的并非针对俄罗斯	
伊朗“敲山震虎”，对以色列发起反击，警告美国不要轻举妄动！	
二战坦克大战，盟军坦克对德国豹式坦克，台风战机：我来帮忙了	
美国最新洲际导弹-民兵洲际导弹成功试射，可精准打击任何地方	
美军快艇安装新武器，伊朗除了导弹艇，别的快艇在其面前都是渣	
此国士兵年薪世界第一，武器比美国还先进，作战能力却几乎为零	
美军舰艇和战机已部署完毕，盟友支援不断，伊朗却依旧毫不畏惧	
动真格！越南突然放弃南部数百口油井，我国舰船满载导弹南下！	
全套美制空战武器被俄式防空导弹天天瞄准，隐身战机估计要黄了	
世界上能造潜艇的国家有多少？门槛比三代机低，不少小国也能造	
国产弹射航母舰岛“亮相”：告别巡洋舰模式，追上福特号航母！	
为何俄军防空系统在空袭中毫无作为？只因以色列拿出一款超强武器	
以色列大规模空袭开始！伊朗多个军事目标遭遇打击，誓言对等反击	
伊朗面对危机异常强硬，准备更多导弹武器，不需任何国家指手画脚	
军费多少都不嫌多 美明年国防预算超7000亿美元 创历史之最	
奇怪！解放军97式步枪为何在加拿大很受欢迎？原因曝光国人乐了	
以色列宣布进入全面备战状态，上百辆坦克已部署完毕，随时可进攻	
世界上的著名手榴弹：美国很可爱，瑞士威力可调节，德国最特别！	
氢弹杀伤力比原子弹要大4000多倍，为什么美俄还要销毁氢弹？	
台湾造出《战狼2》里的机枪无人机，火力强大，其真实性能如何？	
美军为何如此重用日裔将领？原因揭开，美国人这心机耍的太明显！	
数十艘军舰围攻俄后院，普京：72小时全部撤离，否则全部击沉！	
俄罗斯大阅兵众多先进装备亮剑，这是彰显实力震慑对手的绝佳机会	
法国曾免费送航母，我国为何不犹豫直接拒绝？结果证明决定太正确	
多少枚东风导弹能够击毁一艘美航母？答案让人振奋！美国提心吊胆	
城市攻坚取得决定胜利！叙政府军再获大捷，新战术让反叛武装难堪	
德国飞行员纷纷选择提前退役，拦都拦不住，只因俄罗斯的疯狂飞行	
俄罗斯空军在即将举行的纪念二战胜利73周年活动前进行飞行彩排	
战友全部遇难！海军的这场事故让人痛心，中国人，请哀悼！请致敬	
刚刚！俄罗斯举行万人大阅兵，多款未来武器亮相，能否重回巅峰？	
炸锅！055大驱两大技术将用于国产航母，中国制造再次领先世界	
俄罗斯阅兵街头彩排，群众看着印度士兵大笑，解放军出场掌声一片	
运20这一黑科技首度被曝光，将应用在歼20上，彻底追平美国！	
以色列70枚导弹轰炸伊朗：俄罗斯壁上观 伊朗兄弟国为啥集体叫好	
30枚导弹突然砸向以色列，俄军事行动开始，美航母紧急驰往地中海	
这边将交付首架F35，那边出售防空导弹，美俄谁更能拉拢土耳其？	
史上最快战争，以色列二战坦克对埃及T55坦克，埃及六天就战败！	
俄罗斯的“铠甲-C1”有多厉害，竟能击落美国F-35隐身战机！	
歼20终于出海了！一出手果然不同凡响，五角大楼：这下彻底麻烦了	
15万多国大军正加紧武装 开赴叙利亚：美军最怕两大煞星终于来了	
大批歼11B呼啸飞来，越南海警开足马力逃离，被扣渔民愁容变笑颜	
三角梅养殖基本知识	
锡盟春播生产全面展开	
南瓜根茎病虫害怎样防治？	
牡丹种植技术及病虫害防治	
美国农产品为什么这么便宜？	
从美国农场经济模式看启迪与警示	
棉蓟马要打几遍农药，你怎么看？	
病虫害防治｜西瓜白粉病的识别与防治	
我国首款全自动芝麻播种机在无棣投用	
海原近期降水天气 对农作物生长有利	
图集：辣椒秧苗正上市，买上几棵种地里	
如何有效解决养殖池塘的“泥皮”问题？	
桃细菌性穿孔病——如何准确防治桃树病害	
今年樱桃沟樱桃减产，果农每家损失二三万	
哈市一院精准扶贫“三步走”促使农户早脱贫	
散户养猪出路在哪里，看看丹麦的规律就知道了	
养殖成本6元，3元/斤补助，他们含泪倒鱼入江	
养猪小诀窍：用这三样东西养猪，一年能省好多钱！	
为何在农民眼中不值钱的东西？养猪户们却抢着要呢？	
京海禽业：依靠科技，带动农户，为乡村振兴争作贡献	
家里都有的东西，在养殖中却能帮咱解决多方面的问题	
养殖户们，来领补贴了！8项养猪补贴，散户也有福利！	
农村养殖户的新福利，快来领补贴啦，散户也不能错过哦！	
“新品”嫁接果树上市了，好打理，果子多得都得送邻居吃	
西瓜苗被虫子吃了，除了打农药，还有什么办法可以解决？	
中国海关先查农药残留，再查有害生物！美国果农很受伤！	
大爷把西瓜嫁接南瓜上，一月后出现这样的一幕难以相信！	
万能果树嫁接神器上市了，好栽无须多打理，剁手也要买几棵	
美搬起石头砸自己脚！保护主义致农产品泛滥，产值达到千亿	
5月6日全国水产新闻总汇，各地区水产品塘口档口价格报价	
5月12日全国水产新闻总汇，各地区水产品塘口档口价格报价	
15X25米农村新中式小院，经济美观，能养鸡鸭，有菜园！	
坚守43年，将生产、生态和生活完美结合，稳坐台湾第一休闲农场	
猪价持续低迷，上市养猪集团赔了多少钱？普通小散户想都不敢想！	
四大家鱼“青鱼”价格2018多少钱一斤？一年长多大？怎么养殖？	
农村养殖30天左右的“速成鸭”，是不是有激素，人吃了有影响吗？	
「醉美行走」观乡间稻田，品夏日稻香 泰来插秧文化旅游节要开场啦！	
瓜农分享挑西瓜秘籍：记住这5点，挑个薄皮甜瓜只要2秒钟！太实用了	
鲜鲅鱼价格大幅度上涨 休渔初鲜野生海鲜量少价高 养殖大虾50一斤	
8424西瓜，从4月底每斤2.5元一直回落到1.5元！瓜农很无奈！	
书法中的矛盾美	
上联:千杯不醉？	
上联：烟锁池塘柳？	
诗词欣赏：西塞山怀古	
对联赏析：烟锁池塘柳	
临屏对联——自娱自乐1	
上联: ，烟锁池塘柳？	
上联：大长今如今长大？	
快速掌握毛笔书法入门知识	
上联：江南烟雨柳；求下联	
诗词里的五月，原来这么美	
上联：解手，下联如何对？	
上联：寒鸦飞数点；求下联	
楷书间架结构28法图文版	
上联：断桥桥未断，下联？	
上联：一年春又尽；求下联	
上联:富人养骄子，下联？	
上联：悠悠天底树；求下联	
下联：昨夜春草生；求上联	
上联:读史始知史（始）？	
下联：落花自断肠；求上联	
下联：春花开万家；求上联	
上联：握手一长叹；求下联	
上联：荷塘月色美，求下联？	
上联：女子好，如何对下联？	
上联：青山不老，下联：……	
上联：有缘人，如何对下联？	
上联，塞翁失马，焉知祸福？	
27号·诗词：沁园春·怀古	
上联：雪飘飘，下联怎么对？	
上联:荷叶鱼儿伞，求下联？	
上联：耳听为虚；请接下联？	
上联：有节有香有骨；求下联	
最美牡丹花，最美牡丹诗词！	
上联：气吞万里如虎；求下联	
上联：徽宗擅书画 请对下联	
双林诗词群雅集《六十二期》	
上联:十面埋伏刀斧手，下联？	
上联：南征北战，下联怎么对？	
上联：百鸟朝凤，下联怎么对？	
上联：清风吹月影，求对下联？	
下联：离别相思酒一杯，上联？	
上联，心安茅屋稳，求对下联？	
鼓山摩崖石刻——尽览书法胜景	
上联：人间悲欢谁做主；求下联	
上联:投石问路，怎么对下联？	
上联：碧草萋萋遍山野 求下联	
一树梨花压海棠。谁来一上联？	
上联：多心未必是好事；下联？	
上联：乱云飞渡。怎么对下联？	
上联：烟因火起，如何对下联？	
下联：铜雀台上无铜雀；求上联	
上联：当归不归，如何对下联？	
上联：近水楼台先得月；求下联	
诗词名句集锦：千古情思酒一壶	
下联：举杯消愁愁更愁；求上联	
下联：离别家乡岁月多；求上联	
上联：万家灯火，下联怎么对？	
下联：昨夜星辰昨夜风；求上联	
下联；相亲怎能一次成；求上联	
上联：三山五岳来相聚；求下联	
下联：荷叶五寸荷花娇；求上联	
上联：勾心斗角，如何对下联？	
上联：拜托彩云捎书信；求下联	
下联：爱在心里口难开；求上联	
上联：长天云共舞，怎么接下联？	
上联：为人民服务，下联如何对？	
上联：奇马谁人骑，如何对下联？	
上联:火边论世界，如何对下联？	
上联：仙山升明月，下联怎么对？	
上联：田在心上思故乡，求下联？	
上联：松下听风语，下联怎么对？	
上联：雄心装天下，如何对下联？	
上联：依窗伴月闲听曲，求下联？	
上联：一山遮日月，如何对下联？	
上联：本是同根生，如何对下联？	
上联:一叶扁舟轻帆卷，求下联？	
上联：酒尽情犹在，如何对下联？	
上联：读一首情诗，下联怎么对？	
上联，绿竹引清风，如何对下联？	
上联：驸马不是马，下联怎么对？	
上联：一夜春风去，怎么对下联？	
上联：夕阳无限好，下句如何对？	
下联：心有灵兮一点通。求上联？	
上联：佛顶山顶佛，下联如何对？	
上联：月明扰清风。如何对下联？	
上联：杯中藏美酒，如何对下联？	
上联:把酒吟佳句，怎么对下联？	
上联：勤为摇钱树，下联怎么对？	
上联：月移青山动，下联如何对？	
上联：天高任鸟飞，下联如何对？	
上联：烟锁池塘柳，如何对下联？	
上联：天地分上下，如何对下联？	
上联：起舞弄清影，如何对下联？	
上联：江山千古秀，怎么对下联？	
上联：一夜风光去。如何对下联？	
上联：清风扫月影，如何对下联？	
上联：煮酒论英雄，如何接下联？	
上联：道观中观道，如何对下联？	
上联，隐居山林红楼梦，求下联？	
上联：日出东方亮，如何对下联？	
下联：春浅柳疏疏，上联怎么对？	
荐读｜诗词里的五月，原来这么美	
上联:香中别有韵，如何对下联？	
上联：下雨天留客，如何对下联？	
上联世间万物皆有情下联怎么对？	
上联：三思方举步，下联怎么对？	
上联：山水含芳意，下联如何对？	
上联：半世风光路，下联如何对？	
上联：灿是火山。有什么下联吗？	
上联：心遥无近路，如何对下联？	
上联：锄禾日当午，如何对下联？	
下联：火树银花雪飘落。求上联？	
上联：天下无难事，怎么对下联？	
上联：绿水浮白鹅。如何对下联？	
上联，岁月如歌吟作诗，求下联？	
上联:落笔驚风雨，怎么对下联？	
对联，烟锁池塘柳？下联怎么对？	
上联：无钱可断酒，求下联：……	
下联：只恨春情短，如何对上联？	
上联：疏疏密密风，如何接下联？	
上联：一勤生百巧；怎么对下联？	
上联：刀闲易生锈，怎么对下联？	
上联：心回唐宋学诗词，请对联？	
上联：彼岸花开处，下联怎么对？	
上联：人在路上想，如何对下联？	
下联：牵手赏残阳，如何对上联？	
上联:十里荷塘风光好。求下联？	
上联：四面云山皆入眼，求下联？	
上联：粗茶有真味，下联如何对？	
上联：子将父作马，有什么下联？	
上联：老子骑牛读书，下联怎么对？	
上联：老百姓，有哪些合适的下联？	
上联：月下品茶悟道，如何对下联？	
上联:小村落炊烟袅袅。请对下联？	
上联:老子天下第一，下联怎么对？	
上联：人生百年有限，如何对下联？	
上联：一窗月色堆愁绪；求对下联？	
上联:“明月无今古”如何对下联？	
出上联：诗无情无味，如何接下对？	
上联：足不出户可知万物？求下联？	
诗词里的五月，原来这么美（赏心）	
上联:黑发不知勤学早；请接下联？	
上联：远亲不如近邻，怎么对下联？	
上联：煮酒清贫熬岁月，下联怎么对？	
上联：拜托流云捎往事，如何对下联？	
上联：不冷不热五月天，如何对下联？	
下联：三山五岳住八仙，如何对上联？	
上联：雾罩天地成一色，下联如何接？	
上联：蜜蜂采花花不语，下联怎么对？	
上联：自古书香称雅士，怎么对下联？	
上联：遍地鲜花摇落地，如何对下联？	
上联：残柳败荷蝉苦叫，如何对下联？	
上联：人到暮年多彻悟，如何对下联？	
上联：笑看红尘人不老，如何对下联？	
上联：千年一梦几人醒，怎么对下联？	
上联:鸟寻花径知春到，如何对下联？	
上联：只恐夜深花睡去，如何对下联？	
上联：风花雪月的年华，下联怎么对？	
上联：飘飘渺渺九峰山，如何对下联？	
上联：淡饭粗茶有真味，怎么对下联？	
上联：高山流水妙曲高，下联怎么对？	
上联：琴棋书画秀才乐，下联怎么对？	
上联：推窗但见杏花笑，下联怎么对？	
上联：青梅竹马今何在，如何对下联？	
上联：竹影扫阶尘不动。下联怎么对？	
上联：斟杯冬月敲诗句，如何对下联？	
上联：半壶浊酒邀谁饮，如何对下联？	
上联：浅看红楼终是梦，怎么对下联？	
上联：千家百味盐为首，如何对下联？	
上联：相思河畔种相思，下联怎么对？	
上联：品茶品味品人生，如何对下联？	
上联：青山不记当年事，怎么对下联？	
上联:残花落地声声泣，下联怎么对？	
下联：三月桃花正春风，如何对上联？	
上联：壶中无酒难留客，如何对下联？	
上联：重阳登山看秋色，下联如何对？	
上联：半真半假半明月，如何出下联？	
上联：信步庭前看花落，下联有哪些？	
上联：杯中有酒赏明月，怎么对下联？	
上联：七彩花树七彩云，如何对下联？	
上联：一窗一月一春秋，如何对下联？	
上联：墙上画马不能骑，怎么对下联？	
上联，日新日新日日新，如何对下联？	
上联：贫在闹市无人问，下联怎么对？	
上联：芳华渐逝泪朦胧，如何对下联？	
上联：书匠育才不用釜，如何对下联？	
上联：格外垂青窗外柳，下联怎么对？	
上联：算盘错打错盘算，下联怎么对？	
上联：枯藤老树昏鸦叫，如何对下联？	
上联：连天风雨送四月，如何对下联？	
上联：公鸡打架头对头，下联怎么对？	
上联：五花八名乱对联，如何对下联？	
上联：不求芳名留千古，如何对下联？	
上联：逼上梁山成好汉，如何对下联？	
上联：古松迎来上山客，如何对下联？	
下联:静坐窗前听雨声，上联怎么对？	
上联，红烛流泪诉离情，如何对下联？	
上联：牵牛花不会牵牛，下联怎么对？	
上联“鸟啼村上春树”，下联怎么对？	
上联：你坏你坏你真坏，如何对下联？	
上联：夏日无情送春归，如何对下联？	
上联：深深庭院春来晚，如何对下联？	
上联：风清月明品香茗，怎么接下联？	
上联：花开富贵喜浓浓，下联怎么对？	
上联：路边野花休要采，下联怎么对？	
上联：无意走入画图中，如何对下联？	
上联：千片枫林经霜红，怎么对下联？	
上联：乱石穿空今夜雨，如何对下联？	
上联：风吹干了相思忆，如何对下联？	
上联：自古春花无限好，如何对下联？	
上联：梨花带雨朦胧月，如何对下句？	
上联：东岸烟花西岸灯，如何对下联？	
上联：无可奈何花落去，下联怎么对？	
上联：情歌对唱糊涂爱；如何对下联？	
上联：酒醒方知残夜苦，如何对下联？	
上联：对牛弹琴牛尾舞，如何对下联？	
上联：香烟美酒催人老，下联如何对？	
上联：新根拱裂千年石，如何对下联？	
上联：酒醉不知日暮白，如何对下联？	
上联:雨润娇花花伴雨，下联怎么对？	
上联：春风唤醒千棵柳，如何对下联？	
上联：世态炎凉谁笑看，如何对下联？	
上联：山静水流开画景，如何对下联？	
上联：东风宛转春花艳，怎么接下联？	
上联：桃花问柳何时绿，有哪些下联？	
女子好主日月晴，如何对下联或上联？	
上联：心术不可得罪于天地。求下联？	
下联：清风亭上轻风停，如何对上联？	
上联：层层叠叠多多彩，如何对下联？	
上联：一灯点破百年暗，如何对下联？	
上联，花落花开自有时，如何对下联？	
上联：千言万语一杯酒，下联如何对？	
上联：长长长长长长长，如何对下联？	
上联：一山一水一风景，如何对下联？	
上联：玉女抚琴深闺里，如何对下联？	
上联：幽泉落涧疑似雾，下联怎么对？	
上联：千丝万缕九天落，下联怎么对？	
上联：水面文章风写出，如何对下联？	
上联：雪凝成冰冷入骨，如何对下联？	
上联：雨后美景天际来，下联怎么对？	
上联：望梅止渴可止渴，怎么对下联？	
上联：暖日和风送春雨，如何对下联？	
下联:夕陽西下已黄昏。上联是什麽？	
上联：踏云登月开天路，怎么接下联？	
上联：忐忑心中分上下，如何对下联？	
上联:万事到头都是梦，怎么对下联？	
上联：守得云开见月明，如何接下联？	
上联：花开彼岸本无岸，如何对下联？	
上联是浊酒一杯谁同醉，下联怎么对？	
上联：江南烟雨诗中景，如何对下联？	
上联：晨雨携风叩窗扉，下联如何对？	
上联：花开半夏芬芳尽，如何对下联？	
上联：君子之交淡如水，如何对下联？	
上联：万丈红尘三杯洒，下联如何作？	
上联：月伴孤灯笔伴情，如何对下联？	
上联：老子出行就是牛，如何对下联？	
上联：出对容易对对难，如何对下联？	
上联：大酱含将非武将，下联如何对？	
上联：半夜风声惊旧梦，下联如何对？	
上联:文章应读三千卷，怎么对下联？	
上联：春暖花开芳草绿，如何对下联？	
上联：今日洞房花烛夜，下联怎么对？	
上联：入戏太深难自拔，下联怎么对？	
上联：一入红尘深似海，如何对下联？	
上联：风花雪月情万里，如何对下联？	
下联:脚踏实地创大业，如何对上联？	
上联：一床一被一佳人，怎么对下联？	
下联:不求人间大富贵，上联怎么对？	
上联：井底之蛙见识短，如何对下联？	
上联：门口问声女子好，下联如何对？	
上联：灵蛇不羡龙高贵，下联怎么对？	
下联：相思夜中有相思，怎么接上联？	
出，上联：空有欲求无需有，求下对？	
上联：昙香一现夜半开，如何对下联？	
上联：明月无言挂天际；高手请赐下联	
上联：清风绕塌传诗韵，怎么对下联？	
上联：红叶哪得伤秋色？高手请赐下联	
上联是天增岁月娘增寿，下联怎么对？	
上联：司空见惯朝中事，下联怎么对？	
上联：琴中古曲月偷听，如何对下联？	
对联：写对无词因酒少。下联是什么？	
上联：多少柔情犹在眼，怎么对下联？	
下联：一经一声一庙寺，上联怎么对？	
上联：山水不解人情语，怎么对下联？	
上联：一杯清茶请明月，如何对下联？	
上联：哭哭啼啼生下来，如何对下联？	
上联：诗句常来花下醉，如何对下联？	
上联：惊涛拍岸千堆雪，怎么对下联？	
上联：江湖河流海洋深，如何对下联？	
上联，学好对联是爱好。怎么对下联？	
上联：高手过招招招险，如何对下联？	
上联:稻草绑秧父抱子。如何对下联？	
上联：曾经沧海难为水，下联：……？	
上联：几处春风惊笔墨，如何对下联？	
上联：夫妻本是同林鸟，如何对下联？	
上联：一年四季春为首。下联怎么对？	
上联：两袖清风书正气，如何对下联？	
上联：滴破春愁今夜雨，下联怎么对？	
上联：雾里看花花不语；高手请赐下联	
下联：留得残荷听雨声，如何对上联？	
上联：往事成空一梦中，下联怎么对？	
上联：清风明月清明至，怎么接下联？	
上联：蛟龙出水浪作伴，如何对下联？	
上联：寂寞寒窗空守寡，如何对下联？	
上联：雨过枝头花落泪，怎么对下联？	
上联：野花不种年年有，如何对下联？	
上联：凡心一点几时去，下联怎么对？	
上联：铮铮铁骨男儿志，如何对下联？	
上联：江水流尽四月景，如何对下联？	
上联：天若有情天亦老，下联如何对？	
上联：夜静人空忽明志，下联怎么对？	
上联：花开花落一生死，如何对下联？	
上联：垂柳甩钩钓明月，下联怎么对？	
上联:人生不易风风雨雨，怎么对下联？	
上联：悲欢离合全是故事，怎么接下联？	
求下联，上联：老子天下第一，求下联？	
上联：花落花生生生不息，怎么对上联？	
上联是：彩虹桥美无人过，下联怎么对？	
上联：眼观六路耳听八方，如何对下联？	
对联：上联：闭门推出窗前月。求下联？	
上联：屠苏醉元日，好不惬意！求下联？	
上联“一担重泥遇子路”，下联怎么对？	
哪些吟咏牡丹的诗词佳作令你印象深刻？	
上联：凉凉风送笛声远，请你来接下联～	
上联是：月下谈情虫儿听，怎么对下联？	
上联：鼠无大小名称老，能对出下联吗？	
「微·阅读」诗词里的五月，原来这么美	
上联：千年留下，留下千年，下联怎么对？	
我出上联:春风渡江两岸绿。请君出下联？	
上联:“冬雪已尽空山露”，下联怎么对？	
上联“处处红花红处处”，谁有好的下联？	
下联：一人从众，随波逐流。怎么对上联？	
下联：两岸清风拂绿柳，你能对出上联吗？	
上联 :江郎才尽语无伦次。怎么对下联？	
上联：岸边垂柳枝繁叶茂，下联该怎么对？	
原创上联：夕阳美好近黄昏，下联如何对？	
出一上联：三更雨打梧桐叶，下联如何对？	
上联，一杯清茶，解解解元之渴。求下联？	
上联：对对不对，日日心累，下联怎么对？	
上联：东看西看，看看东西。如何对下联？	
画月上联：深居幽谷无俗事，下联怎么对？	
上联：好友三千，却无人聊天，如何对下联？	
上联：逝一人生一人不多不少，有什么下联？	
上联：谁人能把天捅穿，有哪些合适的下联？	
下联：将死方知万事空。有哪些合适的上联？	
上联：头枕青山，看浮云落日。如何对下联？	
上联，日月潭边谈日月，探索宇宙。求下联？	
上联：昏灯掩明月，欲哭无泪，如何对下联？	
上联：花开花落唯有书香不散，下联怎么对？	
上联：山水山山水水山水相连，如何对下联？	
上联：唱不尽人间生旦净末丑；怎么对下联？	
原创上联：春风吹皱一池春水，下联如何对？	
偶得一上联：霜染枫叶片片醉，下联怎么对？	
上联:春风似剪，剪开红花数万朵。求下联？	
上联仄，下联平，横批来关联。如何对下联？	
儿孙济济滔滔福 笑对人生五百年 原创诗词	
上联：人逢喜气精神爽，有哪些合适的下联？	
上联：荒地三千，不如良田一亩，如何对下联？	
上联：文原创，园内桃花三二枝；怎么接下联？	
上联：弹古筝唱民歌，雅俗共赏。如何对下联？	
上联：旭日半尺高，淡霞轻雾笑，如何对下联？	
上联：半夜三更半，中秋八月中。如何对下联？	
上联：才疏学浅，在下斗胆出题。怎么对下联？	
上联：为佳对，日日常思绝妙句，下联怎么对？	
下联：独相思，一年将尽夜难眠。如何对上联？	
上联：世事识势，食诗是难实腹。下联怎么对？	
对联：春风不是酒，易把痴人醉。怎么对下联？	
上联是这样的：读者读《读者》，下联如何对？	
上联：斗智不生气，生气不斗气。怎么对下联？	
上联：手掌摇摇，五指三长两短，下联怎么对？	
下联：村对千棵树，春风吹又生。上联怎么对？	
上联：父进士子进士父子皆进士。下联是什么？	
文原创，上联：春风催眠不觉醒，如何对下联？	
上联：诗美景美人更美美不胜收，下联怎么对？	
上联是：此乃绝对，绝对对不出来，下联是什么？	
上联：风雨同舟半生缘，不离不弃，下联如何对？	
上联：大地无声，黄土岂能埋笑貌，下联怎么对？	
上联：走南闯北，心中独爱东西巷，下联怎么对？	
上联：前怕龙，后怕虎，一事无成。如何对下联？	
上联：小子不才，闲时出来只点赞，下联如何对？	
上联:戏演古今情，善恶忠奸收眼底，请对下联？	
上联：晨曦绯红望云山五彩映芳华，有什么下联？	
上联：酷日如炉云似火，烈石焚山，如何对下联？	
上联：风花雪月道进人生酸甜苦辣，如何对下联？	
上联”东西南北四面风面面俱到”，下联怎么对？	
上联：写字男，难写字，男写难字，如何对下联？	
上联，竹伴桃花，君子喜贪红粉色。如何对下朕？	
上联：目旁是贵，瞆眼不会识贵人；如何对下联？	
下句：萤火虽小，却敢与皓月争辉；如何对上联？	
上联：高山流水，天涯何处觅知音，如何对下联？	
千古绝对！上联：“老牛吃嫩草”，下联太经典了	
上联：江水悠悠流不尽，昼夜无声，下联如何对？	
自动驾驶汽车何时上路？	
自动驾驶汽车上路存法律风险	
三维度推动网约车生态创新发展	
加拿大驾照在我国能直接用吗？	
消除隐患 青平交警保一路畅通	
开车永相伴的驾驶证你了解它吗？	
驾驶证主页密封不完全有影响吗？	
开老年代步车上路需要驾驶证吗？	
刚刚拿到驾驶证不敢上路怎么办？	
驾驶证主页密封不完全会有影响吗？	
开老年代步车上路 需要用驾照吗？	
东岗交警查获一起实习期内酒驾违法行为	
新手拿到驾照后，可以在市区上路开吗？	
刚拿到驾照的小伙伴，上路之前先看看这个	
全力打响事故防控攻坚战 华州交警在行动	
车辆违章上路被扣留 车主起诉交警被驳回	
通用汽车仍在等待在纽约测试其自动驾驶汽车	
新英朗小伙跑滴滴2年 乘客落下的物品大盘点	
再搞不清楚这几种标志，三本驾照都不够你扣的	
这种车不用驾照也能上路，公路上越来越多了！	
武乡交警全力做好省道维修路段交通安全管理工作	
自动驾驶最重要的是啥，能让黑莓CEO吹一波？	
刚刚！这个城市正式约谈滴滴：请立即停止违规经营	
提了新车刚上路，被交警拦下并吊销驾照，车主懵了	
丰田研究院在密歇根设自动驾驶测试场 10月开放	
2018新能源汽车及自动驾驶产业城市实力排行榜	
这八种“酒驾”误区必须知道，不然上路就会被抓！	
众泰与福特再次牵手！看中了网约车新兴市场的大蛋糕	
“查隐患”：东岗交警查处一起故意遮挡号牌违法行为	
你知道么？这种驾照，拥有者号称有轮子的东西都能开！	
我国滴滴打车最火的五个城市，你所在的城市有上榜吗？	
外国牛人用木头造汽车，时速123公里，交警让上路！	
开车上路忘记带驾驶证，而且驾驶证还在外地，该怎么办？	
美国发生了一起Uber自动驾驶汽车撞死行人的交通事故	
百场创新型企业招聘会在宁举行	
被称为土豪国家的沙特阿拉伯，当地工作人员的薪资水平如何？	
绝地求生：内部员工工资曝光 已经超过韩国最高工资限额！	
美国卡车运输行业陷入危机，薪资超高却找不到合格的卡车司机	
美国普通人一个月 3000 美元的工资，为什么觉得 iphone x 贵？	
为什么华尔街做金融的公司，喜欢招聘做理论物理研究的博士？	
别人家的老板 澳一所公司只上班5小时还拿全额工资	
大揭密：俄罗斯“副局级”干部工资到底有多少？	
工资上涨3.6%但通货膨胀是3.2%！加拿大5月加息几成定局	
加息加息！美国购房成本再上升！年化薪资涨幅低于3%！	
三四线城市银行行长一年的工资大概是多少？	
三线城市工资多少才合适？	
上市券商涨工资 人均薪酬提升17%至47万元	
小米上市在即，员工薪资暴涨！	
小米员工薪酬福利曝光，平均年薪才16万？	
越南外企工资普遍底下，工人呼吁涨工资	
在美国普通老百姓工资有多高呢？	
饼皇出走太阳？火箭难放行，1亿薪资谁不想要？	
感动！美国善良女中学生用兼职工资为好友买礼物	
感动！美善良女中学生用兼职工资为好友买礼物	
假如一个女生有钱有时间之后，建议学什么东西工资高好就业？	
昆明理工大学附属小学招聘德语教师 业绩突出者可解决事业编制	
临港产业区夏季人才招聘会下周开始 百家企业等你来	
没想到这七所分数不高的二本院校，毕业生薪资还挺剽悍！	
那些总是玩车，越野或者是自驾的人都是做什么工作的，工资怎样？	
那些总是玩车、越野或者是自驾的人都是做什么工作的，工资怎样？	
青阳成功举办 “贫困劳动者专场”招聘会	
他从小在孤儿院长大 新秀赛季拿出全部工资为家里还债	
雄安大事记：雄安新区招聘650人，还给住房补贴！	
英雄联盟职业解说每个月的工资有多少？	
地震十年，北川涅槃	
福特销量开始滑坡 新一代翼虎能否再现“百年车企”的奇迹？	
巴菲特业绩滑坡，他究竟错失了什么？	
美国证监会对以太坊的裁定会在数字货币世界引发一场地震	
十年北川｜浴火重生，地震废墟上开出“希望之花”	
2013年拍摄的北川地震遗址，那时刚好五周年	
北川中学十年，地震后救援第三天，被抬出来的是遇难学生的遗体	
补时长达17分钟！汉堡降级主场燃起大火，球迷受伤被抬出场外	
汉堡降级引骚乱，主场燃起大火	
球迷不满降级向场内投掷烟火，汉堡主场起大火警察进场	
一名游客到南美洲游玩的时候，夜里碰上了大暴雨	
英雄联盟，TP双修流EZ在赛场上大火，应该如何克制？	
只要思想不滑坡，办法总比困难多	
“地震男孩”成为空降兵：长大后，我真的成了你	
92岁的马哈蒂尔当选，是马来西亚最具历史意义的政治地震？	
巴西婚礼专机坠落着火 新娘无恙婚礼如期举行	
德国现役台风战机只有4架具备实战能力，这说明了什么？	
俄罗斯后院失火，大批军舰突然现身，普京强势回应：再不走都打沉	
菲律宾莱特岛附近海域5.6级地震 震源深10公里	
航母遇到台风怎么办？会被吹翻吗，看来你担心多了	
警惕！巴西24层高楼发生大火后坍塌，仍有逾40人下落不明，高层住宅火灾逃生法则你知道吗？	
喀什又地震啦	
肯尼亚持续暴雨引发洪灾	
肯尼亚洪灾已造成132人死亡	
肯尼亚洪灾已造成132人死亡 超22万人流离失所	
肯尼亚洪灾已造成132人死亡 超过22万人流离失所	
美国阿拉斯加南部海域5.5级地震 震源深度10公里	
美国地质勘探局：美国加利福尼亚州Ocotillo Wells发生5.7级地震	
美国夏威夷州6.9级地震火山爆发万人紧急疏散，愿华侨同胞平安	
内有火灾，外有外交官被驱逐，普京如何“突出重围”？	
欧盟国家联合研制台风战斗机，为何法国要独立使用阵风战机？两款战机谁更强一些？	
三架俄战机冲向叙利亚基地？叙军解除锁定，结果炸弹落下引发地震	
她在新加坡即将成为母亲，命运轨迹被10年前的地震彻底改变	
太惨了！龙门吊被狂风吹垮 印度最新护卫舰被砸个正着	
为什么印度没有台风？	
叙利亚突发地震只因以色列隐形战机轰炸？与伊朗死磕双方战事激烈	
一场暴雨过后，新西兰现罕见巨型天坑！两个足球场那么大！	
伊朗西南部发生地震 造成82人受伤	
意大利罗马一辆公交车发生火灾	
意外反戈！美国盟友公开支持伊朗，此国一表态北约也”地震“	
印度多地遭强风暴雨袭击造成40余人死亡多人受伤	
印度新德里再遇尘暴天气 大风尘土暴雨结伴袭来	
智利近海海域发生5.1级地震 震源深度19.4公里	
专家们预测：印度的这场大火至少还能再烧3800年	
昨晚凌晨洛杉矶又发生4.6级地震了，而且这一次发生在华人聚集地	
今夜起京城再迎大雨，暴雨过后这10种多发病不可不防	
山体滑坡如何应对	
送走台风看肉肉，给多肉们拍个夜照~	
台风天最易发生的意外和疾病怎么破？奉上养生食疗方拿走不谢	
一场暴雨 | 让城建集团交付的新房成了水帘洞	
俄罗斯一养猪场发生大火 消防员救出近150头猪	
信丰消防将再加大力度排查辖区各场所、单位火灾隐患确保辖区安全	
印度火灾死亡人数升至110人	
印度神庙大火：别漠视血与火的“外教”	
应对台风“妮妲”，8月2日至4日部分旅客列车临时停运	
这不是演习，实拍美国客机起飞时着火，乘客四散奔逃	
这场大火烧了伦敦百分之八十建筑，却救了伦敦人的性命	
中秋夜台风肆虐沿海多地 风雨后有心痛更有感动	
注意黑龙江省气象台7月21日11时发布暴雨预报 可能会有强降水、雷暴大风、冰雹	
祖国又霸气了！上次新西兰地震包机，这次以色列大火包车	
让人无法想象的俄台风级内设：桑拿房与游戏室样样不少的核潜艇	
日本人认为对地震灾区的最大支援是什么？	
首次社会力量参与救灾桌面演练在京举办	
受台风“妮妲”影响 北京铁路局始发13趟列车停运	
受台风“鲇鱼”影响  7趟列车停运	
受台风“鲇鱼”影响 多趟列车停运	
受台风“鲇鱼”影响，9月27至29日上铁停运103趟旅客列车	
受台风“鲇鱼”影响，9月28至29日上铁增加停运32趟列车	
中医入门必背之药性赋	
解病患于沉疴 播善行于杏林	
这九种中风前兆，出现请迅速就医	
深度解读｜对临床试验的4大误解	
顿顿胡吃海塞 你离糖尿病就不远了	
糖尿病患者该如何正确使用格列喹酮？	
中风夏季发病率高，中医古方疗效显著	
「永平科普」高血压流行的一般规律！	
医生“痛骂”病人儿女不孝竟然获锦旗	
高血压必读——长寿的生活习惯养成记	
「永平科普」艾滋病能通过空气传播吗？	
直击印度的免费医疗，依靠神力来治疗疾病	
我的中医入门向导，有没有和我一样的同学	
心血管主任医师：高血压春季饮食5宜5忌	
「永平科普」高血压有哪些表现及如何诊断！	
中医思维原创 经络的实质？就像大海的洋流	
高血压患者注意：洛尔类降压药该如何停药？	
手掌诊断病症：九宫八卦图系列简单明了《2》	
手掌诊断病症：九宫八卦图系列简单明了《3》	
手掌诊断病症：九宫八卦图系列简单明了《1》	
罗西已经出院，将于第二天再次到医院接受检查	
南京市第二医院招募基因1型和2型慢性丙肝患者	
50万人大型研究：糖尿病患者也可吃新鲜水果！	
什么！脑机接口可让中风患者快速、准确的打字？	
得了糖尿病不能长寿？这里的长寿经，等你来取！	
HPV疫苗上市，打了疫苗后就不会患宫颈癌了吗？	
阴阳两虚型多见于糖尿病合并症中后期，补肾活血是关键	
宫颈癌疫苗正式上市为期不远，接种之前请掌握这些知识点	
在我国边境亮相的一支部队，他们常年渺无人烟，只为暗中保护	
看一看传统中医对现代人多见的上热下寒体质是如何调理的	
属于中医人的户外活动，你学会了吗？	
总丢三落四，应调理心、脾、肾，中医有个简便的小妙招	
天啦噜，糖尿病会导致阳痿？！丨一周资讯	
Uber CEO：将在几个月内重启自动驾驶测试	
自动驾驶汽车如何应对大雪等极端天气？	
Waymo自动驾驶汽车被撞，现场发生了什么？	
自动驾驶汽车又出了事故，但这次违规的可能是人类	
自动驾驶汽车的“眼睛”：国产激光雷达几乎无话语权	
Uber的自动驾驶软件在事故发生前检测到了行人，但是	
资讯｜戒尺加电棍 国学基地被指“暴力改造问题学生”	
财富置业招聘 后来的我们，成为了同事！	
现在的年轻人，是怎么看待畜牧养殖行业的？	
畜禽养殖场粪污种养一体模式，一种新型沼气红泥发酵袋！	
2018年薪资最高的十大行业是哪些？要找/换工作的快来看看！	
2018高考来临，这几类大学家长学生“切记”慎重选择！	
5000米高空，15名解放军为救人舍命一跃，险些牺牲！	
2018年养猪场拆迁补偿有多少？	
20大地产高管薪酬！最高年薪2.9亿！	
他用美人计大败日军小分队，歼灭鬼子30人	
最值得考生报考的3所985，考上的都是“铁饭碗”	
3所“最不出名”大学，却是211名校！每年高考分都很低！	
二战日裔美军的442团，你了解多少？	
45天佛系省钱驾照“速成”经历分享	
500现代军人能否对抗古代10万人？	
你的驾驶证用对了吗？C1本都有什么用处？	
让卷福、抖森“比心”简直太难！这绝对是“比心界的泥石流”	
「学族教育」通知：小/初学生要注意，新标准要看准咯！	
地震走红可乐男孩10年创业开俩店，生意红火	
写字不好看，高考答题会吃亏吗？	
为什么很少听到大学有校园暴力？很多人都不知道	
暂停登记网络预约出租汽车？网约车办证难度加大	
来了?超预期120年,大断层部分倾斜70度!科学家预估不出地震大小	
乘客遇害，滴滴到底有多大的责任？	
滴滴司机月入过万，为何那么多人不想做？	
顶尖公募基金公司中国区HRD告诉你最内部的招聘标准	
特岗教师招聘开始了，条件艰苦，为什么还那么多人报考？	
“实习期内扣满6分就会注销驾驶证”？真的是这样？！	
很多人都分不清 驾照扣12分和24分有什么区别？	
网约车的风险有大多？	
乡政府大院建起“扶贫电站”	
长期高血压会损伤哪些脏器	
夏季高血压会“忽悠”人，防“忽悠”降压秘籍看这里！	
高血压药会影响性功能？年轻男性一定要看看	
高血压有个大帮凶，它们常常“形影不离”“狼狈为奸”	
我市收听收看2018年全国高考安全工作视频会	
上课的时候教育学生，被学生顶撞，该怎么办？	
驾驶共享汽车出事故，如何确定赔偿责任？	
大方交警开展形式丰富多彩的“五个一”进驾校活动	
解放军进疆部队单身问题得不到解决，各地方征召五万名女兵支援！	
4万件出土兵器，揭秘2200年前秦朝黑科技，误差不到一根头发丝	
农村夫妻集市上开特色面馆，最符合乡下人的口味，每天收入千元	
交警黑科技全面上线！以后再这样后果严重！	
集黑科技于一身，高速“移动交警”即将到来！	
第三次创业、黑科技、智能驾驶，你们说这家企业有多牛？	
到今天你还相信“高考改变命运”吗？真的有很多人因此改变了吗？	
加油站工资不到2500, 为什么很多人却抢着干？到底有啥“内幕”	
NBA球星到手工资有多少？很多人只能拿到一半，大多数需养家糊口	
95后就业大数据：互联网行业受宠，薪资达到6-8K	
在互联网时代，如何做农产品的销售“大赢家”？	
花样农场理财游戏系统定制开发	
[话筒]高层写字楼遇火灾 如何逃出生天？[疑问]	
[话筒]秋季控制火源 预防火灾	
猪场室内槽式翻抛机猪屎翻耙机猪场环保污水处理零排放养殖	
「会议」儿童临床营养治疗培训班通知~	
家庭农场是以后的养猪模式吗，大家是怎么想的？	
申报家庭农场需要什么条件，多少亩地可以报家庭农场？	
学生与教师发生口角，学生打电话回家，家长领多人到学校追打该教师，对此你怎样看？	
NHTSA发布关于驾驶辅助系统的消费者指南	
科目三还没考，驾驶新能源汽车可以吗？	
驾照没有拿到之前可以驾驶新能源汽车吗？	
教练：科目三还没考，驾驶新能源汽车可以吗？	
滴滴的“不作为”与二更的“人血馒头”，论企业的心性	
火箭队现役球员薪资，依据2017-2018赛季各自表现从新签约，将会如何分配？	
今年兵团计划招聘4017名事业单位工作人员	
何来的精准大范围轰炸？战争中听名而栗的大杀器！	
「检察室专栏」预防校园欺凌 护航少年成长——桥南检察室联合未检科法治宣传进校园	
红泥沼气袋一种用于农村养猪场沼气发酵的装置！	
我市举办农机信息化工作培训班	
门票免费的5A景区有这么多！你去过几个？哪里更好玩？	
军事黑科技：现代工兵必备装甲架桥车 克服地形遇水架桥	
人工智能应用军事会不会出现变异，专家呼吁抵制	
美团招聘文案称“不要开大众的”，开大众车的为什么会被歧视？	
“开心农场”让村民心更甜	
在校大学生入伍可以考军校吗？	
17年入伍，什么时候可以考军校？	
志愿填报专家整理的大学理科专业及就业介绍，共15页，可领电子版	
种植户都说果园养鸡效果好，可养鸡会对果树有伤害吗？	
空军运-20飞机首次开展空降空投训练	
交警教你手机快处交通事故，拍照技巧	
交警提醒，这4类汽车再便宜也不能买，买了就上当了！	
交警提醒，这4类汽车再便宜也不能买，买了等着后悔吧！	
汽车大V自驾游体验vivo X21：原来手机还能这么玩	
NBA地震级别的交易！牵动着NBA历史发展的格局！不服不行！	
等发了工资，一定要藏私房钱偷偷买的汽车黑科技，显摆有面上档次	
这个连长脑子秀逗，打赢还不跑，非要等人家大部队来，结果被围殴	
准备进面吧！安徽医科大学第一附属医院招聘笔试成绩出来啦！	
讨论：华为公司都常在哪些学校招聘，你知道吗？	
红昇农场公司切实关心贫困户	
世界上禁止装空调的国家，老百姓半年工资能买奔驰	
世界上禁止装空调的国家，老百姓半年工资能买奔驰！	
这3种主食能拯救你的高血压，5分钟就能学会做法！	
农业农村部 财政部关于做好2018年农业生产发展等项目实施工作的通知	
为什么农产品会滞销？	
土地托管，是农村耕地未来发展的方向吗？	
再过20天，农村会“嫁接”技术的有福了，每天赚200元保底	
如何申请农村家庭农场？超详细！	
现在农村人为什么都不种地了？	
身为农村人，你真的知道乡镇的区别吗？到底那个更高级一点呢？	
对于农村学生来说，高考失利意味着什么？	
我的时空农场积极参与我国乡村振兴战略实施	
边防部队和普通军人有什么区别？	
猪业寒冬，这家饲料企业的做法真暖心	
农民种了几万斤红枣，价格太低，送养殖场喂羊图个什么？	
为什么军事题裁电影里的狙击手一般都是两个人一组？	
填报志愿的软件有什么值得推荐的吗？	
12岁小孩高考考620分，超一本线135分，这么小的孩子去上大学真的好吗？	
为什么很多同学高考成绩很低但还是要上大学呢？	
听说驾照实习期内不能扣分，不能上高速，延长实习期……	
加油站工资不到2500为啥都抢着干？工作人员：虽然少但人是变通的	
我市拟出台意见激励社工人才发展完善薪酬保障提高社工职业地位	
2018年种地别用那么多化肥了！能省就省吧！	
昨见胭脂笔，今开瘦客花 咏月季花诗词一组	
《想你在夜里》诗词组合三首	
受益一生的49条汽车驾驶技巧大全，建议收藏!	
填志愿到底是先选专业还是先选学校呢？	
常用汉字的篆体字对照，喜欢的朋友们抓紧收藏吧	
“手机网吧”藏身校门口 学生租手机一天仅需5元	
天降暴雨惹的祸，小区物业是否应担责？	
养猪还能继续不，看完这些数据就会发现，在农村养殖或将成为历史	
水利强校：河海大学，历年高考录取投档线盘点，勋哥志愿填报指导	
“学校老师没有校外辅导班老师好”？错！错！错！	
高血压用药的四点重要事项	
“民国四大名校”是指哪几所大学，现在排在什么位置？	
2017年录取分数线最高的50所大学是哪些？	
这所大学太强悍，仅是普通211，毕业生工资却“秒杀”清华北大	
农村特色养殖有前途吗？	
为何飞机失事, 宁愿机毁人亡, 也不让乘客跳伞?	
通知：今年起，农民千万不要在农田干这5件事，不然土地会被收回	
「创分享」“网红佛系招聘”大火，启示了什么？	
班级家长群里，为什么老师对有的家长提的问题都有回应，有的明明看到了也不理？	
专攻农业“下半场”，嗲嘞生活立志为农产品戴上“名牌”	
楼层养猪会是未来所趋吗？	
永年农产品批发市场2018年四月份小油菜价格行情分析	
土地承包法的修改，和乡镇公务员有什么关系？	
2017年最具前瞻性的10项医疗创新科技	
猪价低迷，小养猪场受不了，但规模化大集团赔的更多！	
美军侦查日军基地，随便对着假飞机扔了几颗炸弹	
驾照还没有下来，可以驾驶新能源汽车吗？	
新平台加入 网约车再现“烧钱”大战	
未来10年人的工资会不会涨，幸福指数会不会变高？	
乙肝治疗性疫苗有了新进展，战友又有治愈希望啦！	
春季在养鸡行业中十分重要，注意事项要知道	
食醋在养鸡中有什么妙用？	
穿心莲在养殖中有什么作用？	
人工养殖的虾和野生虾有什么区别？	
「三农教程」7步教你开一场农产品线上发布会	
因为一场大火 这个男人减掉了近300斤 他是怎么做到的？	
一高中负债千万请校友捐款 要求学生千元起捐	
如何让一个企业承认不符合应聘直接要求的应聘者的确拥有根本的工作能力？	
2018.5.8猪价 猪价再叫一声“跌”，养猪人：我卖车还不行么	
对联和楹联有什么不同？	
19考研，想学隧道，有哪些学校值得推荐？	
我省今年27.3万余人报名参加高考，较去年减少1万余人	
2018.5.6 生猪价格 暴雨蓝色预警会不会给生猪带来利好	
面对5元的生猪价格，这三种养殖场要撑不住了！	
2018高考报名人数达975万人！比去年增加35万人！	
市场分析｜原药有涨有跌，2018年农药行情扑朔迷离？	
招4017人！新疆生产建设兵团事业单位招聘	
国产大飞机又有新进展 CR929性能令人惊喜	
歼20战机难以量产传闻被破！官方曝最新进展：已能进行实战	
“不服气，不甘心”男子连续高考21次没上大学，希望考上四川大学	
最好的文科大学、理科大学、工科大学有哪些？	
2017年全国重点高校录取分数线排名，真实实力的比拼！	
2018北京大学自主招生初审通过名单（1719人）	
重磅丨清华大学2018年自主招生初审名单公示，省市、中学榜出炉！	
2018年全国参加普通高校招生考试学生975万	
2018年全国普通高校招生考试安全工作电视电话会议召开	
2018年全区普通高校招生工作会召开	
2018年全省普通高校招生考试安全工作电视会议召开	
2018年我省普通高校招生考试工作视频会议在蓉召开	
北京大学这封给考生的信，教家长如何给孩子减压	
新高考选考要开始了 清华北大满分学霸有啥学习秘笈？	
儿子被四川大学数学专业录取，应该不应该上？	
香港大学自主招生条件是什么？	
香港大学自主招生的条件是什么？	
西安电子科技大学录取分是多少？	
武汉大学2018年录取分数线 历年录取最高最低分	
我市召开普通高校招生考试 安全工作会议	
我市收看全国普通高校招生考试安全工作电视电话会议实况	
我市今秋高中招生政策出台 民办学校不得提前自主招生	
同济大学高考录取分数线位列全国第11，为何综合实力却跌出全国前20？	
旅游旺季景区交通压力较大 交警建议乘坐公共交通	
武汉大学被武大学子们戏称为“国家5A级景区”？明明就是吧！	
俄军为何要重忆“第五纵队”？	
解放军、八路军和新四军怎么区分？	
解放军令美军不敢轻举妄动的七大原因	
二战中被神奇保留的文物——科隆大教堂	
解放军亮出巨型秘密武器，国人立即振奋了！	
解放军三大舰队哪个强？曾经各领风骚，如今更加均衡	
解放军“战术布鞋”亮相，看起来很土，但其实有大用处	
亡羊补牢！新式装备终入列，解放军最惨空难不会再发生！	
几个国军高级将领在一起喝闷酒，都不想再和解放军作战了	
外媒评出世界前七项最疯狂的军事训练，咱解放军就占有三项	
国军团长想用人海战术攻城，解放军三百多人布置重火力扫射！	
一只猪引发的战争：超级大国军舰火炮对峙，最终赔偿100元	
历史上的今天：解放军发动上海战役 为避免惊扰市民 露宿街头	
他们以在所有解放军“吃得最好”著称，每天可享受40元标准伙食费	
历史上的珍贵彩照：1945年5月9日在莫斯科红场举行的胜利阅兵	
解放军两栖作战先锋！船坞登陆舰+气垫登陆艇+两栖突击车如何配合	
英家大头菜为农产品地理标志产品	
新能源纯电动汽车怎么驾驶最省电？	
无人小巴开在上海交通大学校园内 自动驾驶主动避人	
去年A股上市公司高管薪酬比拼：金融和房地产业最高	
上市公司薪酬大揭秘：银行人均年薪近30万元！涨薪最多竟然是它？	
南昌大学第二附属医院招聘护理考试通知	
如何理解在读全日制普通高校的非应届毕业生不能用已取得的学历学位作为条件应聘？	
上海财经大学刚毕业一般多少薪资？	
沈阳大学等四所市属高校公开招聘人员面试公告	
事业编制！公安局招聘500名工作人员！赶紧去报名！	
为什么排名第3的武汉大学，毕业生薪酬排名仅88位？	
广东省旅游局发布汛期旅游安全提示信息类型	
今日，我的一位朋友说暴雨天加油站不给加油，这是为什么了？	
暴雨来袭 中山大学校区一条蛇火了	
如果大地震再来临，中国航天能为你做什么？	
失眠的中医药调理，让你脱离安眠药！	
他说，中医药让我免除了一次手术之苦	
中医外科学常考方剂总结，好记不难！	
《中医药法》是中医药的利好还是利空？	
中医药治疗肝纤维化，怎样评价是结果的关键！	
中医医院现行病种分科模式导致很多中医病种消失	
高血压患者北京大学第一医院心内科临床研究招募	
胃癌晚期，首选中医中药，中医治疗有4大注意事项	
中医药真的可以调生男生女吗？让你走出生男生女的误区	
